rank_number,actor,contributions,percent,cumulative_sum,cumulative_percent,all_contributions
1,mnencia,7364,11.62871,7364,11.62871,63326
2,gbartolini,6247,9.86483,13611,21.49354,63326
3,armru,5924,9.35477,19535,30.84831,63326
4,NiccoloFei,3271,5.16533,22806,36.01364,63326
5,litaocdl,2602,4.10890,25408,40.12254,63326
6,itay-grudev,1028,1.62335,26436,41.74589,63326
7,hh24k,806,1.27278,27242,43.01867,63326
8,YanniHu1996,594,0.93800,27836,43.95667,63326
9,jlong49,525,0.82904,28361,44.78571,63326
10,gabriele-wolfox,328,0.51795,28689,45.30367,63326
11,wadlejitendra,297,0.46900,28986,45.77267,63326
12,smiyc,266,0.42005,29252,46.19272,63326
13,danishedb,229,0.36162,29481,46.55434,63326
14,ebgitelman,156,0.24634,29637,46.80068,63326
15,jbattiato,128,0.20213,29765,47.00281,63326
16,MichaluxPL,87,0.13738,29852,47.14020,63326
17,pchovelon,85,0.13423,29937,47.27442,63326
18,Anhui-tqhuang,80,0.12633,30017,47.40075,63326
19,djw-m,75,0.11843,30092,47.51919,63326
20,Ornias1993,69,0.10896,30161,47.62815,63326
21,zekiyeaydemir,66,0.10422,30227,47.73237,63326
22,dragoangel,57,0.09001,30284,47.82238,63326
23,valeriodelsarto,50,0.07896,30334,47.90134,63326
24,GabriFedi97,49,0.07738,30383,47.97871,63326
25,Lennart01,46,0.07264,30429,48.05135,63326
26,Otterpohl,41,0.06474,30470,48.11610,63326
27,thomasboussekey,41,0.06474,30511,48.18084,63326
28,TamaraNocentini,40,0.06317,30551,48.24401,63326
29,ardentperf,39,0.06159,30590,48.30559,63326
30,Stevenpc3,37,0.05843,30627,48.36402,63326
31,philippemnoel,34,0.05369,30661,48.41771,63326
32,afiebig,33,0.05211,30694,48.46982,63326
33,npdgm,33,0.05211,30727,48.52193,63326
34,HaveFun83,32,0.05053,30759,48.57247,63326
35,oberai07,31,0.04895,30790,48.62142,63326
36,weiyentan,31,0.04895,30821,48.67037,63326
37,gpothier,30,0.04737,30851,48.71775,63326
38,sjuls,28,0.04422,30879,48.76196,63326
39,vlasov-y,28,0.04422,30907,48.80618,63326
40,perfectra1n,27,0.04264,30934,48.84881,63326
41,pselliotc,27,0.04264,30961,48.89145,63326
42,Sapp00,27,0.04264,30988,48.93409,63326
43,albundy83,26,0.04106,31014,48.97514,63326
44,BaudouinH,25,0.03948,31039,49.01462,63326
45,maxpain,25,0.03948,31064,49.05410,63326
46,Thab310,25,0.03948,31089,49.09358,63326
47,cschp,23,0.03632,31112,49.12990,63326
48,fullykubed,23,0.03632,31135,49.16622,63326
49,aryklein,22,0.03474,31157,49.20096,63326
50,svenakela,22,0.03474,31179,49.23570,63326
51,wibed,22,0.03474,31201,49.27044,63326
52,dspeck1,21,0.03316,31222,49.30360,63326
53,pascal-hofmann,21,0.03316,31243,49.33677,63326
54,scart88,21,0.03316,31264,49.36993,63326
55,testwill,21,0.03316,31285,49.40309,63326
56,gabrosys,20,0.03158,31305,49.43467,63326
57,georgebarbarosie,20,0.03158,31325,49.46625,63326
58,mikewallace1979,20,0.03158,31345,49.49784,63326
59,myhops,20,0.03158,31365,49.52942,63326
60,rewemkris,20,0.03158,31385,49.56100,63326
61,aradhanabirewar,19,0.03000,31404,49.59101,63326
62,jakubhajek,19,0.03000,31423,49.62101,63326
63,jfyne,19,0.03000,31442,49.65101,63326
64,Mmoncadaisla,19,0.03000,31461,49.68102,63326
65,Adrixop95,18,0.02842,31479,49.70944,63326
66,jessebot,18,0.02842,31497,49.73786,63326
67,josh-heyer,18,0.02842,31515,49.76629,63326
68,lieryan,18,0.02842,31533,49.79471,63326
69,quercus-carsten,18,0.02842,31551,49.82314,63326
70,streamnativebot,18,0.02842,31569,49.85156,63326
71,theadamwright,18,0.02842,31587,49.87999,63326
72,Aelxander,17,0.02685,31604,49.90683,63326
73,sharifmshaker,17,0.02685,31621,49.93368,63326
74,srodenhuis,17,0.02685,31638,49.96052,63326
75,CasperGN,16,0.02527,31654,49.98579,63326
76,dlob,16,0.02527,31670,50.01105,63326
77,sakateka,16,0.02527,31686,50.03632,63326
78,solidDoWant,16,0.02527,31702,50.06159,63326
79,troyt-42,16,0.02527,31718,50.08685,63326
80,jclangst,15,0.02369,31733,50.11054,63326
81,PrivatePuffin,15,0.02369,31748,50.13423,63326
82,theory,15,0.02369,31763,50.15791,63326
83,AntoineMicheaOpencell,14,0.02211,31777,50.18002,63326
84,cam-at-tactiq,14,0.02211,31791,50.20213,63326
85,danielloader,14,0.02211,31805,50.22424,63326
86,DerRockWolf,14,0.02211,31819,50.24634,63326
87,dougkirkley,14,0.02211,31833,50.26845,63326
88,nilsbrenkman,14,0.02211,31847,50.29056,63326
89,simonerocchi,14,0.02211,31861,50.31267,63326
90,augustoribeiro,13,0.02053,31874,50.33320,63326
91,Eykha,13,0.02053,31887,50.35373,63326
92,GioPat,13,0.02053,31900,50.37425,63326
93,JanKarremans,13,0.02053,31913,50.39478,63326
94,KenKilty,13,0.02053,31926,50.41531,63326
95,maaft,13,0.02053,31939,50.43584,63326
96,quay-devel,13,0.02053,31952,50.45637,63326
97,shusaan,13,0.02053,31965,50.47690,63326
98,TillHein,13,0.02053,31978,50.49743,63326
99,Brice187,12,0.01895,31990,50.51638,63326
100,ecksun,12,0.01895,32002,50.53533,63326
101,hollanbm,12,0.01895,32014,50.55427,63326
102,imusmanmalik,12,0.01895,32026,50.57322,63326
103,janiskemper,12,0.01895,32038,50.59217,63326
104,kfkawalec,12,0.01895,32050,50.61112,63326
105,m33li5,12,0.01895,32062,50.63007,63326
106,ns-jhu,12,0.01895,32074,50.64902,63326
107,chris-gooch,11,0.01737,32085,50.66639,63326
108,gl-distribution-oc,11,0.01737,32096,50.68376,63326
109,jpe442,11,0.01737,32107,50.70113,63326
110,Jude0245,11,0.01737,32118,50.71850,63326
111,LaetitiaAvrot,11,0.01737,32129,50.73587,63326
112,M0NsTeRRR,11,0.01737,32140,50.75325,63326
113,seumasdunlop,11,0.01737,32151,50.77062,63326
114,ThomasSpoelstra,11,0.01737,32162,50.78799,63326
115,B1ue-W01f,10,0.01579,32172,50.80378,63326
116,brinnjoyce,10,0.01579,32182,50.81957,63326
117,danielluke,10,0.01579,32192,50.83536,63326
118,dexter136,10,0.01579,32202,50.85115,63326
119,marckhair,10,0.01579,32212,50.86694,63326
120,NigelVanHattum,10,0.01579,32222,50.88273,63326
121,winterrmute,10,0.01579,32232,50.89853,63326
122,zozidalom,10,0.01579,32242,50.91432,63326
123,jgillich,9,0.01421,32251,50.92853,63326
124,MarcusDunn,9,0.01421,32260,50.94274,63326
125,mboutet,9,0.01421,32269,50.95695,63326
126,NaPs,9,0.01421,32278,50.97117,63326
127,99hops,8,0.01263,32286,50.98380,63326
128,adminnz,8,0.01263,32294,50.99643,63326
129,apriebeAVSystem,8,0.01263,32302,51.00906,63326
130,benoitschipper,8,0.01263,32310,51.02170,63326
131,cristianrat,8,0.01263,32318,51.03433,63326
132,gentoorax,8,0.01263,32326,51.04696,63326
133,mrclrchtr,8,0.01263,32334,51.05960,63326
134,NiharDudam,8,0.01263,32342,51.07223,63326
135,nilfr,8,0.01263,32350,51.08486,63326
136,paraddise,8,0.01263,32358,51.09750,63326
137,rlex,8,0.01263,32366,51.11013,63326
138,rocket357,8,0.01263,32374,51.12276,63326
139,Tao-TL,8,0.01263,32382,51.13539,63326
140,8ball030,7,0.01105,32389,51.14645,63326
141,alexpearce,7,0.01105,32396,51.15750,63326
142,bentastic27,7,0.01105,32403,51.16856,63326
143,bozorgmehr96,7,0.01105,32410,51.17961,63326
144,cirilloblu,7,0.01105,32417,51.19066,63326
145,clickersmudge,7,0.01105,32424,51.20172,63326
146,cod-r,7,0.01105,32431,51.21277,63326
147,cterence,7,0.01105,32438,51.22383,63326
148,fenio,7,0.01105,32445,51.23488,63326
149,glemsom,7,0.01105,32452,51.24593,63326
150,johnstonmatt,7,0.01105,32459,51.25699,63326
151,LucaCominoli21,7,0.01105,32466,51.26804,63326
152,lukastopiarz,7,0.01105,32473,51.27910,63326
153,mikeyk,7,0.01105,32480,51.29015,63326
154,mrksngl,7,0.01105,32487,51.30120,63326
155,nareshov,7,0.01105,32494,51.31226,63326
156,NinoSkopac,7,0.01105,32501,51.32331,63326
157,nixonjoshua98,7,0.01105,32508,51.33437,63326
158,Pionerd,7,0.01105,32515,51.34542,63326
159,RaicuRobert,7,0.01105,32522,51.35647,63326
160,rochecompaan,7,0.01105,32529,51.36753,63326
161,samtoxie,7,0.01105,32536,51.37858,63326
162,yonglian,7,0.01105,32543,51.38963,63326
163,0hlov3,6,0.00947,32549,51.39911,63326
164,anaskhantpl,6,0.00947,32555,51.40858,63326
165,awx-auto,6,0.00947,32561,51.41806,63326
166,bhanotjyoti,6,0.00947,32567,51.42753,63326
167,danpe,6,0.00947,32573,51.43701,63326
168,fyannk,6,0.00947,32579,51.44648,63326
169,gsimko,6,0.00947,32585,51.45596,63326
170,itmwiw,6,0.00947,32591,51.46543,63326
171,jamexu98918,6,0.00947,32597,51.47491,63326
172,Jeansen,6,0.00947,32603,51.48438,63326
173,jurim76,6,0.00947,32609,51.49386,63326
174,MoonMoon2,6,0.00947,32615,51.50333,63326
175,mykaua,6,0.00947,32621,51.51281,63326
176,mymasse,6,0.00947,32627,51.52228,63326
177,pratheekrebala,6,0.00947,32633,51.53176,63326
178,qdrddr,6,0.00947,32639,51.54123,63326
179,Routhinator,6,0.00947,32645,51.55071,63326
180,sando38,6,0.00947,32651,51.56018,63326
181,sycured,6,0.00947,32657,51.56966,63326
182,teran,6,0.00947,32663,51.57913,63326
183,Tipsmark,6,0.00947,32669,51.58860,63326
184,winston0410,6,0.00947,32675,51.59808,63326
185,wzzrd,6,0.00947,32681,51.60755,63326
186,xiongcp,6,0.00947,32687,51.61703,63326
187,zifeo,6,0.00947,32693,51.62650,63326
188,albionb96,5,0.00790,32698,51.63440,63326
189,AllardKrings,5,0.00790,32703,51.64230,63326
190,bo0tzz,5,0.00790,32708,51.65019,63326
191,bwdmr,5,0.00790,32713,51.65809,63326
192,cgpoh,5,0.00790,32718,51.66598,63326
193,chrisalavoinehmm,5,0.00790,32723,51.67388,63326
194,Christian-Probst-DATEV,5,0.00790,32728,51.68177,63326
195,clrxbl,5,0.00790,32733,51.68967,63326
196,CodeReaper,5,0.00790,32738,51.69756,63326
197,ColonelBundy,5,0.00790,32743,51.70546,63326
198,Cr4mble,5,0.00790,32748,51.71336,63326
199,csdaraujo,5,0.00790,32753,51.72125,63326
200,df7cb,5,0.00790,32758,51.72915,63326
201,dominikschidlowskidmde,5,0.00790,32763,51.73704,63326
202,fad3t,5,0.00790,32768,51.74494,63326
203,isdinAghmir,5,0.00790,32773,51.75283,63326
204,jdambly,5,0.00790,32778,51.76073,63326
205,JensPauwels,5,0.00790,32783,51.76863,63326
206,kndoni,5,0.00790,32788,51.77652,63326
207,markpapa7,5,0.00790,32793,51.78442,63326
208,mkris98,5,0.00790,32798,51.79231,63326
209,move2kube,5,0.00790,32803,51.80021,63326
210,Nepoxx,5,0.00790,32808,51.80810,63326
211,ngoeddel-openi,5,0.00790,32813,51.81600,63326
212,nick-ivanov-edb,5,0.00790,32818,51.82390,63326
213,olwe0002,5,0.00790,32823,51.83179,63326
214,pfaelzerchen,5,0.00790,32828,51.83969,63326
215,ppfenning92,5,0.00790,32833,51.84758,63326
216,prasanthcaibmcom,5,0.00790,32838,51.85548,63326
217,realulim,5,0.00790,32843,51.86337,63326
218,rwlove,5,0.00790,32848,51.87127,63326
219,scoutinho-randori,5,0.00790,32853,51.87916,63326
220,sinaure,5,0.00790,32858,51.88706,63326
221,stevec-skyhawk,5,0.00790,32863,51.89496,63326
222,StopMotionCuber,5,0.00790,32868,51.90285,63326
223,sujitkagarwal,5,0.00790,32873,51.91075,63326
224,tculp,5,0.00790,32878,51.91864,63326
225,UgurcanAkkok,5,0.00790,32883,51.92654,63326
226,vojtechmares,5,0.00790,32888,51.93443,63326
227,vstariradev,5,0.00790,32893,51.94233,63326
228,walterbaidal,5,0.00790,32898,51.95023,63326
229,4censord,4,0.00632,32902,51.95654,63326
230,Adrelien,4,0.00632,32906,51.96286,63326
231,AJK74,4,0.00632,32910,51.96918,63326
232,AlbinoDrought,4,0.00632,32914,51.97549,63326
233,antodoms,4,0.00632,32918,51.98181,63326
234,AntonioMaccarini,4,0.00632,32922,51.98812,63326
235,BlakeB415,4,0.00632,32926,51.99444,63326
236,buroa,4,0.00632,32930,52.00076,63326
237,chamseddinechrifa,4,0.00632,32934,52.00707,63326
238,christiaangoossens,4,0.00632,32938,52.01339,63326
239,cvrajeesh,4,0.00632,32942,52.01971,63326
240,cyrinux,4,0.00632,32946,52.02602,63326
241,Danieloni1,4,0.00632,32950,52.03234,63326
242,davidpanic,4,0.00632,32954,52.03866,63326
243,deved99,4,0.00632,32958,52.04497,63326
244,devOpsHelm,4,0.00632,32962,52.05129,63326
245,dfsdevops,4,0.00632,32966,52.05761,63326
246,edeustua,4,0.00632,32970,52.06392,63326
247,elliotcourant,4,0.00632,32974,52.07024,63326
248,ember11498,4,0.00632,32978,52.07656,63326
249,epollia,4,0.00632,32982,52.08287,63326
250,ercpereda,4,0.00632,32986,52.08919,63326
251,feenr,4,0.00632,32990,52.09551,63326
252,Felk,4,0.00632,32994,52.10182,63326
253,HanssenKai,4,0.00632,32998,52.10814,63326
254,henrikb77,4,0.00632,33002,52.11446,63326
255,heruan,4,0.00632,33006,52.12077,63326
256,instanacd,4,0.00632,33010,52.12709,63326
257,jacobfederer,4,0.00632,33014,52.13340,63326
258,jarmd,4,0.00632,33018,52.13972,63326
259,jniclas,4,0.00632,33022,52.14604,63326
260,jpabbuehl,4,0.00632,33026,52.15235,63326
261,karlbohlmark,4,0.00632,33030,52.15867,63326
262,kastl-ars,4,0.00632,33034,52.16499,63326
263,kelpoole,4,0.00632,33038,52.17130,63326
264,kirankumar-grootan,4,0.00632,33042,52.17762,63326
265,kiskk,4,0.00632,33046,52.18394,63326
266,lennartack,4,0.00632,33050,52.19025,63326
267,lleshchi,4,0.00632,33054,52.19657,63326
268,Lolliip0p,4,0.00632,33058,52.20289,63326
269,m4s-b3n,4,0.00632,33062,52.20920,63326
270,maxemann96,4,0.00632,33066,52.21552,63326
271,mk-webfleet,4,0.00632,33070,52.22184,63326
272,ndmspcop,4,0.00632,33074,52.22815,63326
273,nhudson,4,0.00632,33078,52.23447,63326
274,NicoJDE,4,0.00632,33082,52.24079,63326
275,NiklasRosenstein,4,0.00632,33086,52.24710,63326
276,ondrej337,4,0.00632,33090,52.25342,63326
277,pboehnke-relativity,4,0.00632,33094,52.25974,63326
278,riadelhajjaji-2001,4,0.00632,33098,52.26605,63326
279,rooftopcellist,4,0.00632,33102,52.27237,63326
280,rustygreen,4,0.00632,33106,52.27868,63326
281,ryanemerson,4,0.00632,33110,52.28500,63326
282,saifulmuhajir,4,0.00632,33114,52.29132,63326
283,Samanyu365,4,0.00632,33118,52.29763,63326
284,samcday,4,0.00632,33122,52.30395,63326
285,sergioenterprisedb,4,0.00632,33126,52.31027,63326
286,sjentzsch,4,0.00632,33130,52.31658,63326
287,Skaronator,4,0.00632,33134,52.32290,63326
288,takeda,4,0.00632,33138,52.32922,63326
289,trent-s,4,0.00632,33142,52.33553,63326
290,tsndqst,4,0.00632,33146,52.34185,63326
291,unbelauscht,4,0.00632,33150,52.34817,63326
292,usernamedt,4,0.00632,33154,52.35448,63326
293,vacquah,4,0.00632,33158,52.36080,63326
294,vatsal-kavida,4,0.00632,33162,52.36712,63326
295,x0ddf,4,0.00632,33166,52.37343,63326
296,xhejtman,4,0.00632,33170,52.37975,63326
297,xoxys,4,0.00632,33174,52.38607,63326
298,53d117460ec63d70,3,0.00474,33177,52.39080,63326
299,9numbernine9,3,0.00474,33180,52.39554,63326
300,aabmets,3,0.00474,33183,52.40028,63326
301,adrienpeiffer,3,0.00474,33186,52.40502,63326
302,altitude1326,3,0.00474,33189,52.40975,63326
303,alvherre,3,0.00474,33192,52.41449,63326
304,anas-hassari-jemmic,3,0.00474,33195,52.41923,63326
305,andyndang,3,0.00474,33198,52.42396,63326
306,AntonFriberg,3,0.00474,33201,52.42870,63326
307,bab5470,3,0.00474,33204,52.43344,63326
308,bennesp,3,0.00474,33207,52.43818,63326
309,BerkayIlhan,3,0.00474,33210,52.44291,63326
310,blodone,3,0.00474,33213,52.44765,63326
311,b-thiswatch,3,0.00474,33216,52.45239,63326
312,capuche2412,3,0.00474,33219,52.45713,63326
313,Casraw,3,0.00474,33222,52.46186,63326
314,cbarria,3,0.00474,33225,52.46660,63326
315,ceriath,3,0.00474,33228,52.47134,63326
316,cleboo,3,0.00474,33231,52.47608,63326
317,coopbri,3,0.00474,33234,52.48081,63326
318,CoreFloDev,3,0.00474,33237,52.48555,63326
319,dannyyy,3,0.00474,33240,52.49029,63326
320,danotrampus,3,0.00474,33243,52.49503,63326
321,Dennis4b,3,0.00474,33246,52.49976,63326
322,DevBey,3,0.00474,33249,52.50450,63326
323,devher0,3,0.00474,33252,52.50924,63326
324,diegonayalazo,3,0.00474,33255,52.51398,63326
325,dkomchenko,3,0.00474,33258,52.51871,63326
326,DriesCruyskens,3,0.00474,33261,52.52345,63326
327,dt-team-kubernetes,3,0.00474,33264,52.52819,63326
328,eddieparker,3,0.00474,33267,52.53292,63326
329,edjmao,3,0.00474,33270,52.53766,63326
330,fernandr,3,0.00474,33273,52.54240,63326
331,fibbs,3,0.00474,33276,52.54714,63326
332,gcasali01,3,0.00474,33279,52.55187,63326
333,hestonravenhood,3,0.00474,33282,52.55661,63326
334,icekom,3,0.00474,33285,52.56135,63326
335,jarlebh,3,0.00474,33288,52.56609,63326
336,jarom-pdk,3,0.00474,33291,52.57082,63326
337,johanra,3,0.00474,33294,52.57556,63326
338,josephlim75,3,0.00474,33297,52.58030,63326
339,jsanto-kepler,3,0.00474,33300,52.58504,63326
340,kasvith,3,0.00474,33303,52.58977,63326
341,knelasevero,3,0.00474,33306,52.59451,63326
342,Knorreman,3,0.00474,33309,52.59925,63326
343,kty1965,3,0.00474,33312,52.60399,63326
344,lbruun,3,0.00474,33315,52.60872,63326
345,lionelhe,3,0.00474,33318,52.61346,63326
346,mbiagetti,3,0.00474,33321,52.61820,63326
347,mbugeia,3,0.00474,33324,52.62294,63326
348,metalwhale,3,0.00474,33327,52.62767,63326
349,miravar,3,0.00474,33330,52.63241,63326
350,mms-gianni,3,0.00474,33333,52.63715,63326
351,mrpotato3,3,0.00474,33336,52.64188,63326
352,muskan-2027,3,0.00474,33339,52.64662,63326
353,mwienk,3,0.00474,33342,52.65136,63326
354,ndrwstn,3,0.00474,33345,52.65610,63326
355,netthier,3,0.00474,33348,52.66083,63326
356,NextFire,3,0.00474,33351,52.66557,63326
357,nmargaritis,3,0.00474,33354,52.67031,63326
358,Ofirfr,3,0.00474,33357,52.67505,63326
359,ohmyglb,3,0.00474,33360,52.67978,63326
360,orlovmyk,3,0.00474,33363,52.68452,63326
361,Pchol,3,0.00474,33366,52.68926,63326
362,pha91,3,0.00474,33369,52.69400,63326
363,pietrobaricco,3,0.00474,33372,52.69873,63326
364,plesoun-stein,3,0.00474,33375,52.70347,63326
365,prehor,3,0.00474,33378,52.70821,63326
366,PseudoResonance,3,0.00474,33381,52.71295,63326
367,rohank2002,3,0.00474,33384,52.71768,63326
368,rwarford,3,0.00474,33387,52.72242,63326
369,sandert98,3,0.00474,33390,52.72716,63326
370,scvalex,3,0.00474,33393,52.73190,63326
371,sgojexcaliber,3,0.00474,33396,52.73663,63326
372,smitpatelx,3,0.00474,33399,52.74137,63326
373,soorajshetty604,3,0.00474,33402,52.74611,63326
374,thdonatello,3,0.00474,33405,52.75084,63326
375,TheNakedZealot,3,0.00474,33408,52.75558,63326
376,theuggla,3,0.00474,33411,52.76032,63326
377,tsgit,3,0.00474,33414,52.76506,63326
378,VergilYotov,3,0.00474,33417,52.76979,63326
379,viorel-anghel,3,0.00474,33420,52.77453,63326
380,Wain13,3,0.00474,33423,52.77927,63326
381,wasd171,3,0.00474,33426,52.78401,63326
382,weiss-m,3,0.00474,33429,52.78874,63326
383,wildGecko,3,0.00474,33432,52.79348,63326
384,zeitler,3,0.00474,33435,52.79822,63326
385,5h4k4r,2,0.00316,33437,52.80138,63326
386,aarne,2,0.00316,33439,52.80454,63326
387,abratanich,2,0.00316,33441,52.80769,63326
388,akramhussein,2,0.00316,33443,52.81085,63326
389,Alan-pad,2,0.00316,33445,52.81401,63326
390,alexdess,2,0.00316,33447,52.81717,63326
391,alexp10,2,0.00316,33449,52.82033,63326
392,aloxlamm,2,0.00316,33451,52.82348,63326
393,alvin319,2,0.00316,33453,52.82664,63326
394,anaskhandevops,2,0.00316,33455,52.82980,63326
395,andremagui,2,0.00316,33457,52.83296,63326
396,aragilar,2,0.00316,33459,52.83612,63326
397,ashish1099,2,0.00316,33461,52.83928,63326
398,ashish1993,2,0.00316,33463,52.84243,63326
399,ashref-ben-hellal,2,0.00316,33465,52.84559,63326
400,b1-luettje,2,0.00316,33467,52.84875,63326
401,BartoszGiza,2,0.00316,33469,52.85191,63326
402,baszalmstra,2,0.00316,33471,52.85507,63326
403,bkief,2,0.00316,33473,52.85823,63326
404,BlueCog,2,0.00316,33475,52.86138,63326
405,boers001,2,0.00316,33477,52.86454,63326
406,bsakweson,2,0.00316,33479,52.86770,63326
407,cbc02009,2,0.00316,33481,52.87086,63326
408,ccben87,2,0.00316,33483,52.87402,63326
409,cdtzabra,2,0.00316,33485,52.87718,63326
410,ch9hn,2,0.00316,33487,52.88033,63326
411,chris-milsted,2,0.00316,33489,52.88349,63326
412,cile98,2,0.00316,33491,52.88665,63326
413,cloudflight-cweiss,2,0.00316,33493,52.88981,63326
414,cloveropen,2,0.00316,33495,52.89297,63326
415,cnwaldron,2,0.00316,33497,52.89612,63326
416,coweos,2,0.00316,33499,52.89928,63326
417,DARB-CCM-S-20,2,0.00316,33501,52.90244,63326
418,debugger24,2,0.00316,33503,52.90560,63326
419,devotional-phoenix-97,2,0.00316,33505,52.90876,63326
420,disconn3ct,2,0.00316,33507,52.91192,63326
421,dit-darius,2,0.00316,33509,52.91507,63326
422,djpirra,2,0.00316,33511,52.91823,63326
423,dkargatzis,2,0.00316,33513,52.92139,63326
424,dnplkndll,2,0.00316,33515,52.92455,63326
425,doctorpangloss,2,0.00316,33517,52.92771,63326
426,doganyazar,2,0.00316,33519,52.93087,63326
427,dperetti,2,0.00316,33521,52.93402,63326
428,edgarkz,2,0.00316,33523,52.93718,63326
429,edib,2,0.00316,33525,52.94034,63326
430,elaurensx,2,0.00316,33527,52.94350,63326
431,elliottneilclark,2,0.00316,33529,52.94666,63326
432,EternalDeiwos,2,0.00316,33531,52.94982,63326
433,fdolsky321,2,0.00316,33533,52.95297,63326
434,fgiorgetti,2,0.00316,33535,52.95613,63326
435,framework20,2,0.00316,33537,52.95929,63326
436,FrankelJb,2,0.00316,33539,52.96245,63326
437,freeznet,2,0.00316,33541,52.96561,63326
438,gapopp,2,0.00316,33543,52.96876,63326
439,ggeorgiev-gitlab,2,0.00316,33545,52.97192,63326
440,Goorzhel,2,0.00316,33547,52.97508,63326
441,gpcmol,2,0.00316,33549,52.97824,63326
442,graphenn,2,0.00316,33551,52.98140,63326
443,gugu,2,0.00316,33553,52.98456,63326
444,harryzcy,2,0.00316,33555,52.98771,63326
445,HaxBaba123,2,0.00316,33557,52.99087,63326
446,Helga09,2,0.00316,33559,52.99403,63326
447,hokaxbt,2,0.00316,33561,52.99719,63326
448,hosseindehghanpoor,2,0.00316,33563,53.00035,63326
449,hpfmn,2,0.00316,33565,53.00351,63326
450,ilbarone87,2,0.00316,33567,53.00666,63326
451,IsaackRasmussen,2,0.00316,33569,53.00982,63326
452,Jamison1,2,0.00316,33571,53.01298,63326
453,janosmiko,2,0.00316,33573,53.01614,63326
454,jdambly-ns,2,0.00316,33575,53.01930,63326
455,jeremie-lesage,2,0.00316,33577,53.02246,63326
456,jflambert,2,0.00316,33579,53.02561,63326
457,jia6214876,2,0.00316,33581,53.02877,63326
458,JoeButler7,2,0.00316,33583,53.03193,63326
459,Joker9944,2,0.00316,33585,53.03509,63326
460,jollyekb,2,0.00316,33587,53.03825,63326
461,justlucknb,2,0.00316,33589,53.04140,63326
462,jwklijnsma,2,0.00316,33591,53.04456,63326
463,kecskesalbert,2,0.00316,33593,53.04772,63326
464,kirillvakalov,2,0.00316,33595,53.05088,63326
465,kkato,2,0.00316,33597,53.05404,63326
466,kkoralsky,2,0.00316,33599,53.05720,63326
467,koolay,2,0.00316,33601,53.06035,63326
468,ksudarsh00,2,0.00316,33603,53.06351,63326
469,kyklos,2,0.00316,33605,53.06667,63326
470,labkey-stuartm,2,0.00316,33607,53.06983,63326
471,linux-wizard,2,0.00316,33609,53.07299,63326
472,MannerMan,2,0.00316,33611,53.07615,63326
473,marcossilvestrini,2,0.00316,33613,53.07930,63326
474,martinr92,2,0.00316,33615,53.08246,63326
475,mdallaire,2,0.00316,33617,53.08562,63326
476,mdegouw,2,0.00316,33619,53.08878,63326
477,meakbiyik,2,0.00316,33621,53.09194,63326
478,mimperatore,2,0.00316,33623,53.09510,63326
479,mirakladp,2,0.00316,33625,53.09825,63326
480,mmanieri,2,0.00316,33627,53.10141,63326
481,morfien101,2,0.00316,33629,53.10457,63326
482,MyDavidAngel,2,0.00316,33631,53.10773,63326
483,ncaak,2,0.00316,33633,53.11089,63326
484,nealcm,2,0.00316,33635,53.11404,63326
485,NebojsaKrtolica,2,0.00316,33637,53.11720,63326
486,Neeraj-Sharma-902,2,0.00316,33639,53.12036,63326
487,NeptuneHub,2,0.00316,33641,53.12352,63326
488,nightcapneal,2,0.00316,33643,53.12668,63326
489,NiklasMayerhauserGH,2,0.00316,33645,53.12984,63326
490,no1here0003,2,0.00316,33647,53.13299,63326
491,Nold360,2,0.00316,33649,53.13615,63326
492,npgretz,2,0.00316,33651,53.13931,63326
493,ns-gzhang,2,0.00316,33653,53.14247,63326
494,nthtrung09it,2,0.00316,33655,53.14563,63326
495,nusratulhassan,2,0.00316,33657,53.14879,63326
496,ockhamlabs,2,0.00316,33659,53.15194,63326
497,odev-swe,2,0.00316,33661,53.15510,63326
498,orenzah,2,0.00316,33663,53.15826,63326
499,orient19,2,0.00316,33665,53.16142,63326
500,ozen,2,0.00316,33667,53.16458,63326
501,PhantomPhreak,2,0.00316,33669,53.16774,63326
502,prezhdarov,2,0.00316,33671,53.17089,63326
503,puppetmaster,2,0.00316,33673,53.17405,63326
504,r10r,2,0.00316,33675,53.17721,63326
505,ramithect,2,0.00316,33677,53.18037,63326
506,Ramki33,2,0.00316,33679,53.18353,63326
507,RatonII,2,0.00316,33681,53.18668,63326
508,rc-networks,2,0.00316,33683,53.18984,63326
509,red-lichtie,2,0.00316,33685,53.19300,63326
510,remotejob,2,0.00316,33687,53.19616,63326
511,reyerdam,2,0.00316,33689,53.19932,63326
512,rickdoq,2,0.00316,33691,53.20248,63326
513,risen228,2,0.00316,33693,53.20563,63326
514,rorynickolls-skyral,2,0.00316,33695,53.20879,63326
515,sadlerap,2,0.00316,33697,53.21195,63326
516,samialitop3,2,0.00316,33699,53.21511,63326
517,schnes4,2,0.00316,33701,53.21827,63326
518,sfisli,2,0.00316,33703,53.22143,63326
519,smartbit,2,0.00316,33705,53.22458,63326
520,smulikHakipod,2,0.00316,33707,53.22774,63326
521,sonali-rajput,2,0.00316,33709,53.23090,63326
522,squakez,2,0.00316,33711,53.23406,63326
523,steve-marmalade,2,0.00316,33713,53.23722,63326
524,stunthamster,2,0.00316,33715,53.24038,63326
525,suleimi,2,0.00316,33717,53.24353,63326
526,szymonrychu,2,0.00316,33719,53.24669,63326
527,tamis-laan,2,0.00316,33721,53.24985,63326
528,teoincontatto,2,0.00316,33723,53.25301,63326
529,tijeshjose001z6h,2,0.00316,33725,53.25617,63326
530,townsendduong,2,0.00316,33727,53.25932,63326
531,Ulrar,2,0.00316,33729,53.26248,63326
532,utaladriz,2,0.00316,33731,53.26564,63326
533,vanakema,2,0.00316,33733,53.26880,63326
534,windupgithubbot1,2,0.00316,33735,53.27196,63326
535,wvengen,2,0.00316,33737,53.27512,63326
536,yacinebbt,2,0.00316,33739,53.27827,63326
537,yaraskm,2,0.00316,33741,53.28143,63326
538,yz4322gly,2,0.00316,33743,53.28459,63326
539,zozo6015,2,0.00316,33745,53.28775,63326
540,02JanDal,1,0.00158,33746,53.28933,63326
541,0x4d6165,1,0.00158,33747,53.29091,63326
542,11qu1d,1,0.00158,33748,53.29249,63326
543,35sui-com,1,0.00158,33749,53.29407,63326
544,4FunAndProfit,1,0.00158,33750,53.29564,63326
545,71g3pf4c3,1,0.00158,33751,53.29722,63326
546,abdo-repos,1,0.00158,33752,53.29880,63326
547,abhishekrajshah,1,0.00158,33753,53.30038,63326
548,abhithetfpl,1,0.00158,33754,53.30196,63326
549,abonander,1,0.00158,33755,53.30354,63326
550,acornett21,1,0.00158,33756,53.30512,63326
551,adampetrovic,1,0.00158,33757,53.30670,63326
552,afarbos,1,0.00158,33758,53.30828,63326
553,afgane,1,0.00158,33759,53.30986,63326
554,ah4i,1,0.00158,33760,53.31144,63326
555,ahmedb24,1,0.00158,33761,53.31302,63326
556,Ahmed-khalil3,1,0.00158,33762,53.31459,63326
557,ahussainrc,1,0.00158,33763,53.31617,63326
558,aivanov-citc,1,0.00158,33764,53.31775,63326
559,ajchiarello,1,0.00158,33765,53.31933,63326
560,a-kailash,1,0.00158,33766,53.32091,63326
561,akirill0v,1,0.00158,33767,53.32249,63326
562,akretschmeredb,1,0.00158,33768,53.32407,63326
563,alahane-techtel,1,0.00158,33769,53.32565,63326
564,Alegrowin,1,0.00158,33770,53.32723,63326
565,AlexanderSehr,1,0.00158,33771,53.32881,63326
566,AlexDaichendt,1,0.00158,33772,53.33039,63326
567,AlfredTM,1,0.00158,33773,53.33196,63326
568,alishchytovych,1,0.00158,33774,53.33354,63326
569,AmodKakade12,1,0.00158,33775,53.33512,63326
570,andonovj,1,0.00158,33776,53.33670,63326
571,Andrew1988123123,1,0.00158,33777,53.33828,63326
572,andy-vm,1,0.00158,33778,53.33986,63326
573,anikoo-nr,1,0.00158,33779,53.34144,63326
574,anmoln4,1,0.00158,33780,53.34302,63326
575,AnushaY1916,1,0.00158,33781,53.34460,63326
576,apavarnitsyn,1,0.00158,33782,53.34618,63326
577,apgapg,1,0.00158,33783,53.34776,63326
578,apjoseph,1,0.00158,33784,53.34934,63326
579,aroundthfur,1,0.00158,33785,53.35091,63326
580,arthurgeek,1,0.00158,33786,53.35249,63326
581,AruPersia,1,0.00158,33787,53.35407,63326
582,audunsol,1,0.00158,33788,53.35565,63326
583,AustralEpitech,1,0.00158,33789,53.35723,63326
584,awoimbee,1,0.00158,33790,53.35881,63326
585,BalaMuralibi,1,0.00158,33791,53.36039,63326
586,baran81,1,0.00158,33792,53.36197,63326
587,barthalion,1,0.00158,33793,53.36355,63326
588,ba-work,1,0.00158,33794,53.36513,63326
589,bb-transpower,1,0.00158,33795,53.36671,63326
590,bennylut,1,0.00158,33796,53.36828,63326
591,bensonyerima,1,0.00158,33797,53.36986,63326
592,bionaut,1,0.00158,33798,53.37144,63326
593,bittermandel,1,0.00158,33799,53.37302,63326
594,bjarn,1,0.00158,33800,53.37460,63326
595,bjw-s,1,0.00158,33801,53.37618,63326
596,black-snow,1,0.00158,33802,53.37776,63326
597,Blitss,1,0.00158,33803,53.37934,63326
598,bonesmoses,1,0.00158,33804,53.38092,63326
599,BongoEADGC6,1,0.00158,33805,53.38250,63326
600,braunsonm,1,0.00158,33806,53.38408,63326
601,brettinternet,1,0.00158,33807,53.38566,63326
602,bryanwieg,1,0.00158,33808,53.38723,63326
603,cameronraysmith,1,0.00158,33809,53.38881,63326
604,carlosrmendes,1,0.00158,33810,53.39039,63326
605,CasLubbers,1,0.00158,33811,53.39197,63326
606,cccsss01,1,0.00158,33812,53.39355,63326
607,cchen-vertica,1,0.00158,33813,53.39513,63326
608,ccrvlh,1,0.00158,33814,53.39671,63326
609,charank922,1,0.00158,33815,53.39829,63326
610,cnolick,1,0.00158,33816,53.39987,63326
611,codelite7,1,0.00158,33817,53.40145,63326
612,codestation,1,0.00158,33818,53.40303,63326
613,ComaVN,1,0.00158,33819,53.40460,63326
614,CommanderStorm,1,0.00158,33820,53.40618,63326
615,cook1emr,1,0.00158,33821,53.40776,63326
616,coolguy1771,1,0.00158,33822,53.40934,63326
617,corentingiraud,1,0.00158,33823,53.41092,63326
618,costigator,1,0.00158,33824,53.41250,63326
619,covert8,1,0.00158,33825,53.41408,63326
620,c-thiel,1,0.00158,33826,53.41566,63326
621,cybercoder,1,0.00158,33827,53.41724,63326
622,dakine1111,1,0.00158,33828,53.41882,63326
623,danieljkemp,1,0.00158,33829,53.42040,63326
624,danielwestermann,1,0.00158,33830,53.42198,63326
625,danpker,1,0.00158,33831,53.42355,63326
626,darktempla,1,0.00158,33832,53.42513,63326
627,datamattsson,1,0.00158,33833,53.42671,63326
628,David-Angel,1,0.00158,33834,53.42829,63326
629,david-curran-90,1,0.00158,33835,53.42987,63326
630,davidpechcz,1,0.00158,33836,53.43145,63326
631,davidradl,1,0.00158,33837,53.43303,63326
632,dba-git,1,0.00158,33838,53.43461,63326
633,debjitk,1,0.00158,33839,53.43619,63326
634,Denton-L,1,0.00158,33840,53.43777,63326
635,DeskPlant,1,0.00158,33841,53.43935,63326
636,DevSecNinja,1,0.00158,33842,53.44092,63326
637,ditpoo,1,0.00158,33843,53.44250,63326
638,dmaclaury,1,0.00158,33844,53.44408,63326
639,dmpe,1,0.00158,33845,53.44566,63326
640,drew9781,1,0.00158,33846,53.44724,63326
641,dsessler7,1,0.00158,33847,53.44882,63326
642,DutchGerman,1,0.00158,33848,53.45040,63326
643,dynapps,1,0.00158,33849,53.45198,63326
644,EBMBA,1,0.00158,33850,53.45356,63326
645,eduscrakozabrus,1,0.00158,33851,53.45514,63326
646,elagree,1,0.00158,33852,53.45672,63326
647,elmerbulthuis,1,0.00158,33853,53.45830,63326
648,Elsayed91,1,0.00158,33854,53.45987,63326
649,emagiz,1,0.00158,33855,53.46145,63326
650,enrico-lumini,1,0.00158,33856,53.46303,63326
651,Enry58,1,0.00158,33857,53.46461,63326
652,ensdhvi,1,0.00158,33858,53.46619,63326
653,eolouw,1,0.00158,33859,53.46777,63326
654,eryalito,1,0.00158,33860,53.46935,63326
655,esakarya,1,0.00158,33861,53.47093,63326
656,evilhamsterman,1,0.00158,33862,53.47251,63326
657,facchettos,1,0.00158,33863,53.47409,63326
658,FacundoAcevedo,1,0.00158,33864,53.47567,63326
659,fakeNews-jpg,1,0.00158,33865,53.47724,63326
660,fanny-jiang,1,0.00158,33866,53.47882,63326
661,felixscheinost,1,0.00158,33867,53.48040,63326
662,ferama,1,0.00158,33868,53.48198,63326
663,filipdutescu,1,0.00158,33869,53.48356,63326
664,fkaempfer,1,0.00158,33870,53.48514,63326
665,Flybro,1,0.00158,33871,53.48672,63326
666,fm4991,1,0.00158,33872,53.48830,63326
667,Foosvald,1,0.00158,33873,53.48988,63326
668,fr6nco,1,0.00158,33874,53.49146,63326
669,fredkanye,1,0.00158,33875,53.49304,63326
670,freyes,1,0.00158,33876,53.49462,63326
671,fuqi1001,1,0.00158,33877,53.49619,63326
672,garribas-atlassian,1,0.00158,33878,53.49777,63326
673,gazab,1,0.00158,33879,53.49935,63326
674,geraldoandradee,1,0.00158,33880,53.50093,63326
675,ghimele,1,0.00158,33881,53.50251,63326
676,ghormoon,1,0.00158,33882,53.50409,63326
677,gideruette,1,0.00158,33883,53.50567,63326
678,gioppoluca,1,0.00158,33884,53.50725,63326
679,gitarns,1,0.00158,33885,53.50883,63326
680,glehmann,1,0.00158,33886,53.51041,63326
681,glesperance,1,0.00158,33887,53.51199,63326
682,gmatej,1,0.00158,33888,53.51356,63326
683,GorlikItsMe,1,0.00158,33889,53.51514,63326
684,Goutman-afk,1,0.00158,33890,53.51672,63326
685,gppmilicia,1,0.00158,33891,53.51830,63326
686,grafanabot,1,0.00158,33892,53.51988,63326
687,Grubla,1,0.00158,33893,53.52146,63326
688,gsreg,1,0.00158,33894,53.52304,63326
689,h0jeZvgoxFepBQ2C,1,0.00158,33895,53.52462,63326
690,hakro,1,0.00158,33896,53.52620,63326
691,Harsesis89,1,0.00158,33897,53.52778,63326
692,Hashdhi,1,0.00158,33898,53.52936,63326
693,hashmap-kz,1,0.00158,33899,53.53094,63326
694,hei829,1,0.00158,33900,53.53251,63326
695,HendrikLevering,1,0.00158,33901,53.53409,63326
696,henro001,1,0.00158,33902,53.53567,63326
697,hsjarbin,1,0.00158,33903,53.53725,63326
698,iamrishav,1,0.00158,33904,53.53883,63326
699,igibek,1,0.00158,33905,53.54041,63326
700,igor-nikiforov,1,0.00158,33906,53.54199,63326
701,ilabrovic,1,0.00158,33907,53.54357,63326
702,ilanssari,1,0.00158,33908,53.54515,63326
703,IlonkaO,1,0.00158,33909,53.54673,63326
704,Inrixia,1,0.00158,33910,53.54831,63326
705,ironytr,1,0.00158,33911,53.54988,63326
706,ivanwel,1,0.00158,33912,53.55146,63326
707,JakobStadlhuber,1,0.00158,33913,53.55304,63326
708,JanKarremans666,1,0.00158,33914,53.55462,63326
709,JasonGao180,1,0.00158,33915,53.55620,63326
710,jawebada,1,0.00158,33916,53.55778,63326
711,jfrconley,1,0.00158,33917,53.55936,63326
712,JJacobuss,1,0.00158,33918,53.56094,63326
713,jlewandowski-lmco,1,0.00158,33919,53.56252,63326
714,jlimai,1,0.00158,33920,53.56410,63326
715,jmcorne,1,0.00158,33921,53.56568,63326
716,jngrb,1,0.00158,33922,53.56726,63326
717,jocutajar,1,0.00158,33923,53.56883,63326
718,joekrill,1,0.00158,33924,53.57041,63326
719,jonaszlasut,1,0.00158,33925,53.57199,63326
720,jordi-t,1,0.00158,33926,53.57357,63326
721,jorgebsa,1,0.00158,33927,53.57515,63326
722,jtackaberry,1,0.00158,33928,53.57673,63326
723,JulienVall3,1,0.00158,33929,53.57831,63326
724,JuroOravec,1,0.00158,33930,53.57989,63326
725,JustinLex,1,0.00158,33931,53.58147,63326
726,justinwyer,1,0.00158,33932,53.58305,63326
727,jvoss,1,0.00158,33933,53.58463,63326
728,karlbaumg,1,0.00158,33934,53.58620,63326
729,Kevinckli,1,0.00158,33935,53.58778,63326
730,kgrimsby,1,0.00158,33936,53.58936,63326
731,khewonc,1,0.00158,33937,53.59094,63326
732,kkoppel,1,0.00158,33938,53.59252,63326
733,K-MeLeOn,1,0.00158,33939,53.59410,63326
734,kokorousaki,1,0.00158,33940,53.59568,63326
735,krs2k,1,0.00158,33941,53.59726,63326
736,kuism,1,0.00158,33942,53.59884,63326
737,L1ghtman2k,1,0.00158,33943,53.60042,63326
738,laukik85,1,0.00158,33944,53.60200,63326
739,lavanyaj3,1,0.00158,33945,53.60358,63326
740,LemonDouble,1,0.00158,33946,53.60515,63326
741,lenaxia,1,0.00158,33947,53.60673,63326
742,lenow55,1,0.00158,33948,53.60831,63326
743,leverege-jphelps,1,0.00158,33949,53.60989,63326
744,levissfuture,1,0.00158,33950,53.61147,63326
745,LewisKSaint,1,0.00158,33951,53.61305,63326
746,lgromb,1,0.00158,33952,53.61463,63326
747,lilambivert,1,0.00158,33953,53.61621,63326
748,lmocofan,1,0.00158,33954,53.61779,63326
749,localbubble,1,0.00158,33955,53.61937,63326
750,lodnert,1,0.00158,33956,53.62095,63326
751,logan-broit,1,0.00158,33957,53.62252,63326
752,loktionovam,1,0.00158,33958,53.62410,63326
753,lrojas89,1,0.00158,33959,53.62568,63326
754,Lyuven,1,0.00158,33960,53.62726,63326
755,m00nyONE,1,0.00158,33961,53.62884,63326
756,majermarci,1,0.00158,33962,53.63042,63326
757,mamy-CS,1,0.00158,33963,53.63200,63326
758,marcossv9,1,0.00158,33964,53.63358,63326
759,mark-webster-catalyst,1,0.00158,33965,53.63516,63326
760,markwebsterUK,1,0.00158,33966,53.63674,63326
761,marrip,1,0.00158,33967,53.63832,63326
762,martinmarques,1,0.00158,33968,53.63990,63326
763,marvinWolff,1,0.00158,33969,53.64147,63326
764,MathCharton,1,0.00158,33970,53.64305,63326
765,ma-ts,1,0.00158,33971,53.64463,63326
766,matthijsvdr,1,0.00158,33972,53.64621,63326
767,mauza,1,0.00158,33973,53.64779,63326
768,maxcoolmakarov,1,0.00158,33974,53.64937,63326
769,Mbaey,1,0.00158,33975,53.65095,63326
770,mblp,1,0.00158,33976,53.65253,63326
771,mboncalo,1,0.00158,33977,53.65411,63326
772,mehrdadbn9,1,0.00158,33978,53.65569,63326
773,melquisedequecosta98,1,0.00158,33979,53.65727,63326
774,meltingrock,1,0.00158,33980,53.65884,63326
775,mfmessaoudi,1,0.00158,33981,53.66042,63326
776,mheijkant,1,0.00158,33982,53.66200,63326
777,miguellords,1,0.00158,33983,53.66358,63326
778,mindthecap,1,0.00158,33984,53.66516,63326
779,mingsterism,1,0.00158,33985,53.66674,63326
780,MKH-Beldi,1,0.00158,33986,53.66832,63326
781,mliker,1,0.00158,33987,53.66990,63326
782,mmeier86,1,0.00158,33988,53.67148,63326
783,moelhoussein,1,0.00158,33989,53.67306,63326
784,MonolithProjects,1,0.00158,33990,53.67464,63326
785,mporrato,1,0.00158,33991,53.67622,63326
786,mpsOxygen,1,0.00158,33992,53.67779,63326
787,mshkpchv,1,0.00158,33993,53.67937,63326
788,msijmons,1,0.00158,33994,53.68095,63326
789,mzhaase,1,0.00158,33995,53.68253,63326
790,n-able-consulting,1,0.00158,33996,53.68411,63326
791,nachi-netskope,1,0.00158,33997,53.68569,63326
792,NeverW8,1,0.00158,33998,53.68727,63326
793,nielsweistra,1,0.00158,33999,53.68885,63326
794,nitinpatil-edb,1,0.00158,34000,53.69043,63326
795,nitishchauhan0022,1,0.00158,34001,53.69201,63326
796,nmarukovich,1,0.00158,34002,53.69359,63326
797,Noah-Huppert,1,0.00158,34003,53.69516,63326
798,nogweii,1,0.00158,34004,53.69674,63326
799,ntx-ben,1,0.00158,34005,53.69832,63326
800,nurbek-workfindme,1,0.00158,34006,53.69990,63326
801,ondrej-smola,1,0.00158,34007,53.70148,63326
802,oscgu,1,0.00158,34008,53.70306,63326
803,osnabrugge,1,0.00158,34009,53.70464,63326
804,os-sengel,1,0.00158,34010,53.70622,63326
805,Pandry,1,0.00158,34011,53.70780,63326
806,panigs7,1,0.00158,34012,53.70938,63326
807,pankaj-band12,1,0.00158,34013,53.71096,63326
808,paoloyx,1,0.00158,34014,53.71254,63326
809,PatrickRogg,1,0.00158,34015,53.71411,63326
810,pepinno,1,0.00158,34016,53.71569,63326
811,pgpie,1,0.00158,34017,53.71727,63326
812,pheianox,1,0.00158,34018,53.71885,63326
813,pierreblais,1,0.00158,34019,53.72043,63326
814,pkehling-IAV,1,0.00158,34020,53.72201,63326
815,pkutakovvk,1,0.00158,34021,53.72359,63326
816,pmontagna,1,0.00158,34022,53.72517,63326
817,ppiont,1,0.00158,34023,53.72675,63326
818,Preisschild,1,0.00158,34024,53.72833,63326
819,Protryon,1,0.00158,34025,53.72991,63326
820,psankar,1,0.00158,34026,53.73148,63326
821,psychonic,1,0.00158,34027,53.73306,63326
822,pushkargr,1,0.00158,34028,53.73464,63326
823,Pwdak,1,0.00158,34029,53.73622,63326
824,qiliq,1,0.00158,34030,53.73780,63326
825,qlqw233,1,0.00158,34031,53.73938,63326
826,r0b1ndot,1,0.00158,34032,53.74096,63326
827,rajramo61,1,0.00158,34033,53.74254,63326
828,ramijebara,1,0.00158,34034,53.74412,63326
829,reederc42,1,0.00158,34035,53.74570,63326
830,retrogaming457,1,0.00158,34036,53.74728,63326
831,rg-ctrl,1,0.00158,34037,53.74886,63326
832,RickVenema,1,0.00158,34038,53.75043,63326
833,ricrug,1,0.00158,34039,53.75201,63326
834,riddhithummar,1,0.00158,34040,53.75359,63326
835,rishinair11,1,0.00158,34041,53.75517,63326
836,Ritikaram1,1,0.00158,34042,53.75675,63326
837,rkthtrifork,1,0.00158,34043,53.75833,63326
838,robasp,1,0.00158,34044,53.75991,63326
839,robcxyz,1,0.00158,34045,53.76149,63326
840,robinvanderknaap,1,0.00158,34046,53.76307,63326
841,robinvanderstraeten-klarrio,1,0.00158,34047,53.76465,63326
842,rohanjayaraj,1,0.00158,34048,53.76623,63326
843,rubasace,1,0.00158,34049,53.76780,63326
844,rubenz91,1,0.00158,34050,53.76938,63326
845,rvos-73,1,0.00158,34051,53.77096,63326
846,Ryder05,1,0.00158,34052,53.77254,63326
847,sajdakabir,1,0.00158,34053,53.77412,63326
848,salotz,1,0.00158,34054,53.77570,63326
849,SalvoRusso8,1,0.00158,34055,53.77728,63326
850,sambonbonne,1,0.00158,34056,53.77886,63326
851,samhamilton,1,0.00158,34057,53.78044,63326
852,sandert-k8s,1,0.00158,34058,53.78202,63326
853,sandroden,1,0.00158,34059,53.78360,63326
854,SanduDS,1,0.00158,34060,53.78518,63326
855,Sebastian-Materna,1,0.00158,34061,53.78675,63326
856,sebastian-pf9,1,0.00158,34062,53.78833,63326
857,sebastianvoss,1,0.00158,34063,53.78991,63326
858,Sebor,1,0.00158,34064,53.79149,63326
859,semnell,1,0.00158,34065,53.79307,63326
860,serafdev,1,0.00158,34066,53.79465,63326
861,sergey-kudriavtsev,1,0.00158,34067,53.79623,63326
862,SergioRomera,1,0.00158,34068,53.79781,63326
863,shajia-deshaw,1,0.00158,34069,53.79939,63326
864,sherlant,1,0.00158,34070,53.80097,63326
865,shiipou,1,0.00158,34071,53.80255,63326
866,shixuguang,1,0.00158,34072,53.80412,63326
867,sigezhao,1,0.00158,34073,53.80570,63326
868,silopolis,1,0.00158,34074,53.80728,63326
869,simardeep1792,1,0.00158,34075,53.80886,63326
870,simonebenati,1,0.00158,34076,53.81044,63326
871,simonebraga,1,0.00158,34077,53.81202,63326
872,simonmacklin,1,0.00158,34078,53.81360,63326
873,simonoff,1,0.00158,34079,53.81518,63326
874,Skarlso,1,0.00158,34080,53.81676,63326
875,sle78,1,0.00158,34081,53.81834,63326
876,slickwilli,1,0.00158,34082,53.81992,63326
877,SmaineTF1,1,0.00158,34083,53.82150,63326
878,SNWCreations,1,0.00158,34084,53.82307,63326
879,Sonali-Rajput,1,0.00158,34085,53.82465,63326
880,SorsOps,1,0.00158,34086,53.82623,63326
881,spantaleev,1,0.00158,34087,53.82781,63326
882,sr12344321,1,0.00158,34088,53.82939,63326
883,sreisich,1,0.00158,34089,53.83097,63326
884,srijanshukla18,1,0.00158,34090,53.83255,63326
885,ssandur-thales,1,0.00158,34091,53.83413,63326
886,stavros-k,1,0.00158,34092,53.83571,63326
887,stephankoelle,1,0.00158,34093,53.83729,63326
888,strelok29,1,0.00158,34094,53.83887,63326
889,stsantilena,1,0.00158,34095,53.84044,63326
890,sud82,1,0.00158,34096,53.84202,63326
891,suhanime,1,0.00158,34097,53.84360,63326
892,T1mK,1,0.00158,34098,53.84518,63326
893,tanmayja,1,0.00158,34099,53.84676,63326
894,taraszka,1,0.00158,34100,53.84834,63326
895,tcraxs,1,0.00158,34101,53.84992,63326
896,TecIntelli,1,0.00158,34102,53.85150,63326
897,teksuo,1,0.00158,34103,53.85308,63326
898,tgumleo,1,0.00158,34104,53.85466,63326
899,Th3Lourde,1,0.00158,34105,53.85624,63326
900,thatMacAdmin,1,0.00158,34106,53.85782,63326
901,thejordanclark,1,0.00158,34107,53.85939,63326
902,TheoBassaw,1,0.00158,34108,53.86097,63326
903,TheRealHaoLiu,1,0.00158,34109,53.86255,63326
904,theSuess,1,0.00158,34110,53.86413,63326
905,ThirVondukr,1,0.00158,34111,53.86571,63326
906,ThomasADavis,1,0.00158,34112,53.86729,63326
907,timbr99,1,0.00158,34113,53.86887,63326
908,tim-brand,1,0.00158,34114,53.87045,63326
909,tjmoore4,1,0.00158,34115,53.87203,63326
910,tmsdce,1,0.00158,34116,53.87361,63326
911,toboshii,1,0.00158,34117,53.87519,63326
912,tom-asmblr,1,0.00158,34118,53.87676,63326
913,tomaszburdka-tomtom,1,0.00158,34119,53.87834,63326
914,tomaszkrzyzanowski,1,0.00158,34120,53.87992,63326
915,tothf,1,0.00158,34121,53.88150,63326
916,tschlaepfer,1,0.00158,34122,53.88308,63326
917,Tyagdit,1,0.00158,34123,53.88466,63326
918,ujala-singh,1,0.00158,34124,53.88624,63326
919,ujanssen,1,0.00158,34125,53.88782,63326
920,urashidmalik,1,0.00158,34126,53.88940,63326
921,urza,1,0.00158,34127,53.89098,63326
922,Valefoth,1,0.00158,34128,53.89256,63326
923,vanyasvl,1,0.00158,34129,53.89414,63326
924,vasyakrg,1,0.00158,34130,53.89571,63326
925,vbezhenar,1,0.00158,34131,53.89729,63326
926,vicrem,1,0.00158,34132,53.89887,63326
927,vitorpavani,1,0.00158,34133,53.90045,63326
928,vongrad,1,0.00158,34134,53.90203,63326
929,vyruss,1,0.00158,34135,53.90361,63326
930,wadle,1,0.00158,34136,53.90519,63326
931,WalissonPires,1,0.00158,34137,53.90677,63326
932,wascript3r,1,0.00158,34138,53.90835,63326
933,Weihrauch,1,0.00158,34139,53.90993,63326
934,wesbragagt,1,0.00158,34140,53.91151,63326
935,WladyX,1,0.00158,34141,53.91308,63326
936,wolframm,1,0.00158,34142,53.91466,63326
937,wsp-git,1,0.00158,34143,53.91624,63326
938,xabufr,1,0.00158,34144,53.91782,63326
939,xenophenes,1,0.00158,34145,53.91940,63326
940,xiaolongkipsi,1,0.00158,34146,53.92098,63326
941,XLordalX,1,0.00158,34147,53.92256,63326
942,yemaney,1,0.00158,34148,53.92414,63326
943,YentlFrickx,1,0.00158,34149,53.92572,63326
944,youngerwarrior,1,0.00158,34150,53.92730,63326
945,yremmet,1,0.00158,34151,53.92888,63326
946,yrro,1,0.00158,34152,53.93046,63326
947,yuriididuk89,1,0.00158,34153,53.93203,63326
948,yyvess,1,0.00158,34154,53.93361,63326
949,zaggash,1,0.00158,34155,53.93519,63326
950,Zeratoxx,1,0.00158,34156,53.93677,63326
951,zfy0701,1,0.00158,34157,53.93835,63326
