rank_number,actor,contributions,percent,cumulative_sum,cumulative_percent,all_contributions
1,itay-grudev,1192,1.68674,1192,1.68674,70669
2,hh24k,807,1.14194,1999,2.82868,70669
3,YanniHu1996,598,0.84620,2597,3.67488,70669
4,jlong49,525,0.74290,3122,4.41778,70669
5,smiyc,347,0.49102,3469,4.90880,70669
6,danishedb,229,0.32405,3698,5.23285,70669
7,MichaluxPL,96,0.13584,3794,5.36869,70669
8,FloorD,41,0.05802,3835,5.42671,70669
9,Stevenpc3,37,0.05236,3872,5.47906,70669
10,gpothier,34,0.04811,3906,5.52718,70669
11,HaveFun83,32,0.04528,3938,5.57246,70669
12,oberai07,31,0.04387,3969,5.61632,70669
13,weiyentan,31,0.04387,4000,5.66019,70669
14,solidDoWant,29,0.04104,4029,5.70123,70669
15,MarcusDunn,28,0.03962,4057,5.74085,70669
16,sjuls,28,0.03962,4085,5.78047,70669
17,perfectra1n,27,0.03821,4112,5.81868,70669
18,pselliotc,27,0.03821,4139,5.85688,70669
19,Sapp00,27,0.03821,4166,5.89509,70669
20,sharifmshaker,27,0.03821,4193,5.93329,70669
21,BaudouinH,26,0.03679,4219,5.97009,70669
22,chris-gooch,26,0.03679,4245,6.00688,70669
23,maxpain,26,0.03679,4271,6.04367,70669
24,svenakela,22,0.03113,4293,6.07480,70669
25,wibed,22,0.03113,4315,6.10593,70669
26,dspeck1,21,0.02972,4336,6.13565,70669
27,quercus-carsten,21,0.02972,4357,6.16536,70669
28,scart88,21,0.02972,4378,6.19508,70669
29,testwill,21,0.02972,4399,6.22479,70669
30,mikewallace1979,20,0.02830,4419,6.25310,70669
31,myhops,20,0.02830,4439,6.28140,70669
32,Aelxander,19,0.02689,4458,6.30828,70669
33,lieryan,18,0.02547,4476,6.33375,70669
34,hokaxbt,17,0.02406,4493,6.35781,70669
35,dlob,16,0.02264,4509,6.38045,70669
36,sakateka,16,0.02264,4525,6.40309,70669
37,troyt-42,16,0.02264,4541,6.42573,70669
38,DerRockWolf,14,0.01981,4555,6.44554,70669
39,dsluo,14,0.01981,4569,6.46535,70669
40,nilsbrenkman,14,0.01981,4583,6.48516,70669
41,quay-devel,14,0.01981,4597,6.50497,70669
42,simonerocchi,14,0.01981,4611,6.52478,70669
43,Eykha,13,0.01840,4624,6.54318,70669
44,GioPat,13,0.01840,4637,6.56158,70669
45,kfkawalec,13,0.01840,4650,6.57997,70669
46,maaft,13,0.01840,4663,6.59837,70669
47,paraddise,13,0.01840,4676,6.61676,70669
48,saolof,13,0.01840,4689,6.63516,70669
49,shusaan,13,0.01840,4702,6.65355,70669
50,TillHein,13,0.01840,4715,6.67195,70669
51,ecksun,12,0.01698,4727,6.68893,70669
52,hollanbm,12,0.01698,4739,6.70591,70669
53,m33li5,12,0.01698,4751,6.72289,70669
54,ns-jhu,12,0.01698,4763,6.73987,70669
55,brinnjoyce,11,0.01557,4774,6.75544,70669
56,Jude0245,11,0.01557,4785,6.77100,70669
57,seumasdunlop,11,0.01557,4796,6.78657,70669
58,B1ue-W01f,10,0.01415,4806,6.80072,70669
59,sebasmannem,10,0.01415,4816,6.81487,70669
60,winterrmute,10,0.01415,4826,6.82902,70669
61,bo0tzz,9,0.01274,4835,6.84176,70669
62,lotheac,9,0.01274,4844,6.85449,70669
63,LucaCominoli21,9,0.01274,4853,6.86723,70669
64,restingbull,9,0.01274,4862,6.87996,70669
65,99hops,8,0.01132,4870,6.89128,70669
66,adminnz,8,0.01132,4878,6.90260,70669
67,apriebeAVSystem,8,0.01132,4886,6.91392,70669
68,cristianrat,8,0.01132,4894,6.92524,70669
69,gsimko,8,0.01132,4902,6.93656,70669
70,kndoni,8,0.01132,4910,6.94788,70669
71,RaicuRobert,8,0.01132,4918,6.95920,70669
72,rlex,8,0.01132,4926,6.97052,70669
73,rocket357,8,0.01132,4934,6.98184,70669
74,Tao-TL,8,0.01132,4942,6.99317,70669
75,8ball030,7,0.00991,4949,7.00307,70669
76,alexklibisz,7,0.00991,4956,7.01298,70669
77,bozorgmehr96,7,0.00991,4963,7.02288,70669
78,cirilloblu,7,0.00991,4970,7.03279,70669
79,clickersmudge,7,0.00991,4977,7.04269,70669
80,cod-r,7,0.00991,4984,7.05260,70669
81,df7cb,7,0.00991,4991,7.06250,70669
82,jpabbuehl,7,0.00991,4998,7.07241,70669
83,majermarci,7,0.00991,5005,7.08231,70669
84,mbiagetti,7,0.00991,5012,7.09222,70669
85,nixonjoshua98,7,0.00991,5019,7.10212,70669
86,pha91,7,0.00991,5026,7.11203,70669
87,steve-marmalade,7,0.00991,5033,7.12193,70669
88,yonglian,7,0.00991,5040,7.13184,70669
89,anaskhantpl,6,0.00849,5046,7.14033,70669
90,awx-auto,6,0.00849,5052,7.14882,70669
91,bhanotjyoti,6,0.00849,5058,7.15731,70669
92,danpe,6,0.00849,5064,7.16580,70669
93,elliottneilclark,6,0.00849,5070,7.17429,70669
94,fpfuetsch,6,0.00849,5076,7.18278,70669
95,fyannk,6,0.00849,5082,7.19127,70669
96,itmwiw,6,0.00849,5088,7.19976,70669
97,jamexu98918,6,0.00849,5094,7.20825,70669
98,lbruun,6,0.00849,5100,7.21674,70669
99,move2kube,6,0.00849,5106,7.22523,70669
100,mymasse,6,0.00849,5112,7.23372,70669
101,qdrddr,6,0.00849,5118,7.24221,70669
102,sando38,6,0.00849,5124,7.25070,70669
103,sujitkagarwal,6,0.00849,5130,7.25919,70669
104,sycured,6,0.00849,5136,7.26768,70669
105,tculp,6,0.00849,5142,7.27617,70669
106,Tipsmark,6,0.00849,5148,7.28467,70669
107,tsndqst,6,0.00849,5154,7.29316,70669
108,Ulrar,6,0.00849,5160,7.30165,70669
109,xiongcp,6,0.00849,5166,7.31014,70669
110,albionb96,5,0.00708,5171,7.31721,70669
111,b1-luettje,5,0.00708,5176,7.32429,70669
112,bwdmr,5,0.00708,5181,7.33136,70669
113,cgpoh,5,0.00708,5186,7.33844,70669
114,chris-milsted,5,0.00708,5191,7.34551,70669
115,clrxbl,5,0.00708,5196,7.35259,70669
116,CodeReaper,5,0.00708,5201,7.35966,70669
117,ColonelBundy,5,0.00708,5206,7.36674,70669
118,Copilot,5,0.00708,5211,7.37381,70669
119,cormacrelf,5,0.00708,5216,7.38089,70669
120,Hazmi35,5,0.00708,5221,7.38796,70669
121,isdinAghmir,5,0.00708,5226,7.39504,70669
122,jdambly,5,0.00708,5231,7.40211,70669
123,l00ptr,5,0.00708,5236,7.40919,70669
124,markpapa7,5,0.00708,5241,7.41626,70669
125,NikolayS,5,0.00708,5246,7.42334,70669
126,nobleess,5,0.00708,5251,7.43042,70669
127,pfaelzerchen,5,0.00708,5256,7.43749,70669
128,plesoun-stein,5,0.00708,5261,7.44457,70669
129,ppfenning92,5,0.00708,5266,7.45164,70669
130,prasanthcaibmcom,5,0.00708,5271,7.45872,70669
131,PseudoResonance,5,0.00708,5276,7.46579,70669
132,rwlove,5,0.00708,5281,7.47287,70669
133,saifulmuhajir,5,0.00708,5286,7.47994,70669
134,samcday,5,0.00708,5291,7.48702,70669
135,sashokbg,5,0.00708,5296,7.49409,70669
136,scoutinho-randori,5,0.00708,5301,7.50117,70669
137,stevec-skyhawk,5,0.00708,5306,7.50824,70669
138,StopMotionCuber,5,0.00708,5311,7.51532,70669
139,vstariradev,5,0.00708,5316,7.52239,70669
140,Adrelien,4,0.00566,5320,7.52805,70669
141,agelwarg,4,0.00566,5324,7.53371,70669
142,AJK74,4,0.00566,5328,7.53937,70669
143,AlbinoDrought,4,0.00566,5332,7.54503,70669
144,AyushChothe,4,0.00566,5336,7.55069,70669
145,bonesmoses,4,0.00566,5340,7.55635,70669
146,briquier,4,0.00566,5344,7.56201,70669
147,chamseddinechrifa,4,0.00566,5348,7.56767,70669
148,davidpanic,4,0.00566,5352,7.57333,70669
149,deved99,4,0.00566,5356,7.57900,70669
150,devOpsHelm,4,0.00566,5360,7.58466,70669
151,ember11498,4,0.00566,5364,7.59032,70669
152,epollia,4,0.00566,5368,7.59598,70669
153,Felk,4,0.00566,5372,7.60164,70669
154,FF-Ninja,4,0.00566,5376,7.60730,70669
155,henrikb77,4,0.00566,5380,7.61296,70669
156,jDmacD,4,0.00566,5384,7.61862,70669
157,kastl-ars,4,0.00566,5388,7.62428,70669
158,kelpoole,4,0.00566,5392,7.62994,70669
159,kirankumar-grootan,4,0.00566,5396,7.63560,70669
160,kiskk,4,0.00566,5400,7.64126,70669
161,koolay,4,0.00566,5404,7.64692,70669
162,legrandlegrand,4,0.00566,5408,7.65258,70669
163,lleshchi,4,0.00566,5412,7.65824,70669
164,Lolliip0p,4,0.00566,5416,7.66390,70669
165,mk-webfleet,4,0.00566,5420,7.66956,70669
166,ndmspcop,4,0.00566,5424,7.67522,70669
167,NicoJDE,4,0.00566,5428,7.68088,70669
168,ondrej337,4,0.00566,5432,7.68654,70669
169,pboehnke-relativity,4,0.00566,5436,7.69220,70669
170,quajones,4,0.00566,5440,7.69786,70669
171,rafal11ck,4,0.00566,5444,7.70352,70669
172,teoincontatto,4,0.00566,5448,7.70918,70669
173,thearperson,4,0.00566,5452,7.71484,70669
174,trcjr,4,0.00566,5456,7.72050,70669
175,unbelauscht,4,0.00566,5460,7.72616,70669
176,utaladriz,4,0.00566,5464,7.73182,70669
177,vacquah,4,0.00566,5468,7.73748,70669
178,vatsal-kavida,4,0.00566,5472,7.74314,70669
179,xhejtman,4,0.00566,5476,7.74880,70669
180,yardenshoham,4,0.00566,5480,7.75446,70669
181,53d117460ec63d70,3,0.00425,5483,7.75871,70669
182,9numbernine9,3,0.00425,5486,7.76295,70669
183,afgane,3,0.00425,5489,7.76720,70669
184,almahmoud,3,0.00425,5492,7.77144,70669
185,altitude1326,3,0.00425,5495,7.77569,70669
186,bab5470,3,0.00425,5498,7.77993,70669
187,bhattacharyasujoy,3,0.00425,5501,7.78418,70669
188,BlueCog,3,0.00425,5504,7.78842,70669
189,cleboo,3,0.00425,5507,7.79267,70669
190,cnwaldron,3,0.00425,5510,7.79691,70669
191,cometship,3,0.00425,5513,7.80116,70669
192,commel,3,0.00425,5516,7.80540,70669
193,dannyyy,3,0.00425,5519,7.80965,70669
194,danotrampus,3,0.00425,5522,7.81389,70669
195,Dennis4b,3,0.00425,5525,7.81814,70669
196,DevBey,3,0.00425,5528,7.82238,70669
197,devher0,3,0.00425,5531,7.82663,70669
198,devotional-phoenix-97,3,0.00425,5534,7.83087,70669
199,diegonayalazo,3,0.00425,5537,7.83512,70669
200,disconn3ct,3,0.00425,5540,7.83936,70669
201,dkomchenko,3,0.00425,5543,7.84361,70669
202,DriesCruyskens,3,0.00425,5546,7.84785,70669
203,dt-team-kubernetes,3,0.00425,5549,7.85210,70669
204,eddieparker,3,0.00425,5552,7.85634,70669
205,edjmao,3,0.00425,5555,7.86059,70669
206,fernandr,3,0.00425,5558,7.86483,70669
207,fgiorgetti,3,0.00425,5561,7.86908,70669
208,fibbs,3,0.00425,5564,7.87332,70669
209,filipdutescu,3,0.00425,5567,7.87757,70669
210,gcasali01,3,0.00425,5570,7.88182,70669
211,grillorafael,3,0.00425,5573,7.88606,70669
212,hestonravenhood,3,0.00425,5576,7.89031,70669
213,icekom,3,0.00425,5579,7.89455,70669
214,jarlebh,3,0.00425,5582,7.89880,70669
215,jarom-pdk,3,0.00425,5585,7.90304,70669
216,johanra,3,0.00425,5588,7.90729,70669
217,josephlim75,3,0.00425,5591,7.91153,70669
218,jsanto-kepler,3,0.00425,5594,7.91578,70669
219,kasvith,3,0.00425,5597,7.92002,70669
220,knelasevero,3,0.00425,5600,7.92427,70669
221,Knorreman,3,0.00425,5603,7.92851,70669
222,krezovic,3,0.00425,5606,7.93276,70669
223,kty1965,3,0.00425,5609,7.93700,70669
224,labkey-stuartm,3,0.00425,5612,7.94125,70669
225,lionelhe,3,0.00425,5615,7.94549,70669
226,Ludea,3,0.00425,5618,7.94974,70669
227,mbugeia,3,0.00425,5621,7.95398,70669
228,metalwhale,3,0.00425,5624,7.95823,70669
229,miravar,3,0.00425,5627,7.96247,70669
230,mms-gianni,3,0.00425,5630,7.96672,70669
231,mrpotato3,3,0.00425,5633,7.97096,70669
232,muskan-2027,3,0.00425,5636,7.97521,70669
233,mwienk,3,0.00425,5639,7.97945,70669
234,ndrwstn,3,0.00425,5642,7.98370,70669
235,netthier,3,0.00425,5645,7.98794,70669
236,NextFire,3,0.00425,5648,7.99219,70669
237,nfaust-edb,3,0.00425,5651,7.99643,70669
238,nmargaritis,3,0.00425,5654,8.00068,70669
239,nthtrung09it,3,0.00425,5657,8.00492,70669
240,ockhamlabs,3,0.00425,5660,8.00917,70669
241,Ofirfr,3,0.00425,5663,8.01341,70669
242,ohmyglb,3,0.00425,5666,8.01766,70669
243,OmarGadd,3,0.00425,5669,8.02190,70669
244,orlovmyk,3,0.00425,5672,8.02615,70669
245,Pchol,3,0.00425,5675,8.03040,70669
246,pietrobaricco,3,0.00425,5678,8.03464,70669
247,prehor,3,0.00425,5681,8.03889,70669
248,pvickery-ParamountCommerce,3,0.00425,5684,8.04313,70669
249,rohank2002,3,0.00425,5687,8.04738,70669
250,rwarford,3,0.00425,5690,8.05162,70669
251,sandert98,3,0.00425,5693,8.05587,70669
252,scvalex,3,0.00425,5696,8.06011,70669
253,sgojexcaliber,3,0.00425,5699,8.06436,70669
254,Sleepful,3,0.00425,5702,8.06860,70669
255,smitpatelx,3,0.00425,5705,8.07285,70669
256,soorajshetty604,3,0.00425,5708,8.07709,70669
257,thdonatello,3,0.00425,5711,8.08134,70669
258,TheNakedZealot,3,0.00425,5714,8.08558,70669
259,theuggla,3,0.00425,5717,8.08983,70669
260,tsgit,3,0.00425,5720,8.09407,70669
261,VergilYotov,3,0.00425,5723,8.09832,70669
262,viorel-anghel,3,0.00425,5726,8.10256,70669
263,Wain13,3,0.00425,5729,8.10681,70669
264,wasd171,3,0.00425,5732,8.11105,70669
265,weiss-m,3,0.00425,5735,8.11530,70669
266,wildGecko,3,0.00425,5738,8.11954,70669
267,wvengen,3,0.00425,5741,8.12379,70669
268,yaraskm,3,0.00425,5744,8.12803,70669
269,zeitler,3,0.00425,5747,8.13228,70669
270,5h4k4r,2,0.00283,5749,8.13511,70669
271,71g3pf4c3,2,0.00283,5751,8.13794,70669
272,aarne,2,0.00283,5753,8.14077,70669
273,abbudao,2,0.00283,5755,8.14360,70669
274,abratanich,2,0.00283,5757,8.14643,70669
275,ah4i,2,0.00283,5759,8.14926,70669
276,akramhussein,2,0.00283,5761,8.15209,70669
277,Alan-pad,2,0.00283,5763,8.15492,70669
278,alexdess,2,0.00283,5765,8.15775,70669
279,alexp10,2,0.00283,5767,8.16058,70669
280,aloxlamm,2,0.00283,5769,8.16341,70669
281,alvin319,2,0.00283,5771,8.16624,70669
282,AmodKakade12,2,0.00283,5773,8.16907,70669
283,anaskhandevops,2,0.00283,5775,8.17190,70669
284,andremagui,2,0.00283,5777,8.17473,70669
285,anthonypelletier,2,0.00283,5779,8.17756,70669
286,appiepollo14,2,0.00283,5781,8.18039,70669
287,aragilar,2,0.00283,5783,8.18322,70669
288,ashish1099,2,0.00283,5785,8.18605,70669
289,ashish1993,2,0.00283,5787,8.18888,70669
290,ashref-ben-hellal,2,0.00283,5789,8.19171,70669
291,atanaspam,2,0.00283,5791,8.19454,70669
292,atimofeev,2,0.00283,5793,8.19737,70669
293,baran81,2,0.00283,5795,8.20020,70669
294,BartoszGiza,2,0.00283,5797,8.20303,70669
295,baszalmstra,2,0.00283,5799,8.20586,70669
296,ba-work,2,0.00283,5801,8.20869,70669
297,beauwest,2,0.00283,5803,8.21152,70669
298,bjarn,2,0.00283,5805,8.21435,70669
299,bkief,2,0.00283,5807,8.21718,70669
300,black-snow,2,0.00283,5809,8.22001,70669
301,boers001,2,0.00283,5811,8.22284,70669
302,bsakweson,2,0.00283,5813,8.22567,70669
303,cbc02009,2,0.00283,5815,8.22850,70669
304,ccben87,2,0.00283,5817,8.23133,70669
305,cdtzabra,2,0.00283,5819,8.23416,70669
306,ch9hn,2,0.00283,5821,8.23699,70669
307,cile98,2,0.00283,5823,8.23982,70669
308,cloudflight-cweiss,2,0.00283,5825,8.24265,70669
309,cloveropen,2,0.00283,5827,8.24548,70669
310,coweos,2,0.00283,5829,8.24831,70669
311,cthtrifork,2,0.00283,5831,8.25114,70669
312,DARB-CCM-S-20,2,0.00283,5833,8.25397,70669
313,debugger24,2,0.00283,5835,8.25680,70669
314,DevSecNinja,2,0.00283,5837,8.25963,70669
315,dit-darius,2,0.00283,5839,8.26246,70669
316,djpirra,2,0.00283,5841,8.26529,70669
317,dkargatzis,2,0.00283,5843,8.26812,70669
318,dnplkndll,2,0.00283,5845,8.27095,70669
319,doganyazar,2,0.00283,5847,8.27378,70669
320,dperetti,2,0.00283,5849,8.27661,70669
321,edesalve,2,0.00283,5851,8.27944,70669
322,edgarkz,2,0.00283,5853,8.28227,70669
323,edib,2,0.00283,5855,8.28510,70669
324,elaurensx,2,0.00283,5857,8.28793,70669
325,Erouan50,2,0.00283,5859,8.29076,70669
326,EternalDeiwos,2,0.00283,5861,8.29359,70669
327,farewell7117,2,0.00283,5863,8.29642,70669
328,fcarucci,2,0.00283,5865,8.29925,70669
329,fdolsky321,2,0.00283,5867,8.30208,70669
330,framework20,2,0.00283,5869,8.30491,70669
331,FrankelJb,2,0.00283,5871,8.30774,70669
332,freeznet,2,0.00283,5873,8.31057,70669
333,gapopp,2,0.00283,5875,8.31340,70669
334,ggeorgiev-gitlab,2,0.00283,5877,8.31623,70669
335,ghimele,2,0.00283,5879,8.31906,70669
336,gideruette,2,0.00283,5881,8.32190,70669
337,Goorzhel,2,0.00283,5883,8.32473,70669
338,GorlikItsMe,2,0.00283,5885,8.32756,70669
339,gpcmol,2,0.00283,5887,8.33039,70669
340,graphenn,2,0.00283,5889,8.33322,70669
341,gugu,2,0.00283,5891,8.33605,70669
342,harryzcy,2,0.00283,5893,8.33888,70669
343,HaxBaba123,2,0.00283,5895,8.34171,70669
344,Helga09,2,0.00283,5897,8.34454,70669
345,hobbit44,2,0.00283,5899,8.34737,70669
346,hosseindehghanpoor,2,0.00283,5901,8.35020,70669
347,hpfmn,2,0.00283,5903,8.35303,70669
348,ilbarone87,2,0.00283,5905,8.35586,70669
349,IsaackRasmussen,2,0.00283,5907,8.35869,70669
350,Jamison1,2,0.00283,5909,8.36152,70669
351,janosmiko,2,0.00283,5911,8.36435,70669
352,jdambly-ns,2,0.00283,5913,8.36718,70669
353,jeremie-lesage,2,0.00283,5915,8.37001,70669
354,jflambert,2,0.00283,5917,8.37284,70669
355,jia6214876,2,0.00283,5919,8.37567,70669
356,joaocosmej,2,0.00283,5921,8.37850,70669
357,JoeButler7,2,0.00283,5923,8.38133,70669
358,Joker9944,2,0.00283,5925,8.38416,70669
359,jollyekb,2,0.00283,5927,8.38699,70669
360,JuroOravec,2,0.00283,5929,8.38982,70669
361,justlucknb,2,0.00283,5931,8.39265,70669
362,jvpasinatto,2,0.00283,5933,8.39548,70669
363,jwklijnsma,2,0.00283,5935,8.39831,70669
364,kecskesalbert,2,0.00283,5937,8.40114,70669
365,kirillvakalov,2,0.00283,5939,8.40397,70669
366,kkato,2,0.00283,5941,8.40680,70669
367,kkoralsky,2,0.00283,5943,8.40963,70669
368,K-MeLeOn,2,0.00283,5945,8.41246,70669
369,ksudarsh00,2,0.00283,5947,8.41529,70669
370,kyklos,2,0.00283,5949,8.41812,70669
371,linux-wizard,2,0.00283,5951,8.42095,70669
372,MannerMan,2,0.00283,5953,8.42378,70669
373,marcossilvestrini,2,0.00283,5955,8.42661,70669
374,marcustut,2,0.00283,5957,8.42944,70669
375,markmaker,2,0.00283,5959,8.43227,70669
376,martinmarques,2,0.00283,5961,8.43510,70669
377,martinr92,2,0.00283,5963,8.43793,70669
378,mdallaire,2,0.00283,5965,8.44076,70669
379,mdegouw,2,0.00283,5967,8.44359,70669
380,meakbiyik,2,0.00283,5969,8.44642,70669
381,metalshanked,2,0.00283,5971,8.44925,70669
382,mimperatore,2,0.00283,5973,8.45208,70669
383,mirakladp,2,0.00283,5975,8.45491,70669
384,mmanieri,2,0.00283,5977,8.45774,70669
385,morfien101,2,0.00283,5979,8.46057,70669
386,MyDavidAngel,2,0.00283,5981,8.46340,70669
387,ncaak,2,0.00283,5983,8.46623,70669
388,nealcm,2,0.00283,5985,8.46906,70669
389,NebojsaKrtolica,2,0.00283,5987,8.47189,70669
390,Neeraj-Sharma-902,2,0.00283,5989,8.47472,70669
391,NeptuneHub,2,0.00283,5991,8.47755,70669
392,newtondotcom,2,0.00283,5993,8.48038,70669
393,nightcapneal,2,0.00283,5995,8.48321,70669
394,NiklasMayerhauserGH,2,0.00283,5997,8.48604,70669
395,no1here0003,2,0.00283,5999,8.48887,70669
396,Nold360,2,0.00283,6001,8.49170,70669
397,npgretz,2,0.00283,6003,8.49453,70669
398,ns-gzhang,2,0.00283,6005,8.49736,70669
399,nusratulhassan,2,0.00283,6007,8.50019,70669
400,odev-swe,2,0.00283,6009,8.50302,70669
401,orenzah,2,0.00283,6011,8.50585,70669
402,orient19,2,0.00283,6013,8.50868,70669
403,ozen,2,0.00283,6015,8.51151,70669
404,PhantomPhreak,2,0.00283,6017,8.51434,70669
405,phccdk,2,0.00283,6019,8.51717,70669
406,pocket-pc,2,0.00283,6021,8.52000,70669
407,pp2699,2,0.00283,6023,8.52283,70669
408,prezhdarov,2,0.00283,6025,8.52566,70669
409,psankar,2,0.00283,6027,8.52849,70669
410,puppetmaster,2,0.00283,6029,8.53132,70669
411,ramithect,2,0.00283,6031,8.53415,70669
412,Ramki33,2,0.00283,6033,8.53698,70669
413,RatonII,2,0.00283,6035,8.53981,70669
414,rc-networks,2,0.00283,6037,8.54264,70669
415,red-lichtie,2,0.00283,6039,8.54547,70669
416,reederc42,2,0.00283,6041,8.54830,70669
417,remotejob,2,0.00283,6043,8.55113,70669
418,reyerdam,2,0.00283,6045,8.55396,70669
419,rickdoq,2,0.00283,6047,8.55679,70669
420,risen228,2,0.00283,6049,8.55962,70669
421,RokeshVS,2,0.00283,6051,8.56245,70669
422,rorynickolls-skyral,2,0.00283,6053,8.56528,70669
423,sadlerap,2,0.00283,6055,8.56811,70669
424,samialitop3,2,0.00283,6057,8.57094,70669
425,SanduDS,2,0.00283,6059,8.57377,70669
426,schnes4,2,0.00283,6061,8.57660,70669
427,sdesbure,2,0.00283,6063,8.57943,70669
428,Sebastian-Materna,2,0.00283,6065,8.58226,70669
429,sebastian-pf9,2,0.00283,6067,8.58509,70669
430,SergioRomera,2,0.00283,6069,8.58792,70669
431,sfisli,2,0.00283,6071,8.59075,70669
432,shahbazaamir,2,0.00283,6073,8.59358,70669
433,simonoff,2,0.00283,6075,8.59641,70669
434,smartbit,2,0.00283,6077,8.59924,70669
435,smulikHakipod,2,0.00283,6079,8.60207,70669
436,SorsOps,2,0.00283,6081,8.60490,70669
437,squakez,2,0.00283,6083,8.60773,70669
438,stuhood,2,0.00283,6085,8.61056,70669
439,stunthamster,2,0.00283,6087,8.61339,70669
440,suhanime,2,0.00283,6089,8.61622,70669
441,suleimi,2,0.00283,6091,8.61906,70669
442,szymonrychu,2,0.00283,6093,8.62189,70669
443,tamis-laan,2,0.00283,6095,8.62472,70669
444,thomaspetit,2,0.00283,6097,8.62755,70669
445,tijeshjose001z6h,2,0.00283,6099,8.63038,70669
446,timbr99,2,0.00283,6101,8.63321,70669
447,townsendduong,2,0.00283,6103,8.63604,70669
448,usma0118,2,0.00283,6105,8.63887,70669
449,vanakema,2,0.00283,6107,8.64170,70669
450,webconn,2,0.00283,6109,8.64453,70669
451,windupgithubbot1,2,0.00283,6111,8.64736,70669
452,yacinebbt,2,0.00283,6113,8.65019,70669
453,yemaney,2,0.00283,6115,8.65302,70669
454,yz4322gly,2,0.00283,6117,8.65585,70669
455,zozo6015,2,0.00283,6119,8.65868,70669
456,02JanDal,1,0.00142,6120,8.66009,70669
457,0x4d6165,1,0.00142,6121,8.66151,70669
458,11qu1d,1,0.00142,6122,8.66292,70669
459,35sui-com,1,0.00142,6123,8.66434,70669
460,4FunAndProfit,1,0.00142,6124,8.66575,70669
461,abdo-repos,1,0.00142,6125,8.66717,70669
462,abhishekrajshah,1,0.00142,6126,8.66858,70669
463,abhithetfpl,1,0.00142,6127,8.67000,70669
464,abonander,1,0.00142,6128,8.67141,70669
465,acornett21,1,0.00142,6129,8.67283,70669
466,adam-brusselback,1,0.00142,6130,8.67424,70669
467,adampetrovic,1,0.00142,6131,8.67566,70669
468,afarbos,1,0.00142,6132,8.67707,70669
469,afaul,1,0.00142,6133,8.67849,70669
470,ahmedb24,1,0.00142,6134,8.67990,70669
471,Ahmed-khalil3,1,0.00142,6135,8.68132,70669
472,ahussainrc,1,0.00142,6136,8.68273,70669
473,aivanov-citc,1,0.00142,6137,8.68415,70669
474,ajchiarello,1,0.00142,6138,8.68556,70669
475,a-kailash,1,0.00142,6139,8.68698,70669
476,akirill0v,1,0.00142,6140,8.68839,70669
477,akretschmeredb,1,0.00142,6141,8.68981,70669
478,alahane-techtel,1,0.00142,6142,8.69122,70669
479,Alegrowin,1,0.00142,6143,8.69264,70669
480,AlexanderSehr,1,0.00142,6144,8.69405,70669
481,AlexDaichendt,1,0.00142,6145,8.69547,70669
482,alexeytarasovpa,1,0.00142,6146,8.69688,70669
483,AlfredTM,1,0.00142,6147,8.69830,70669
484,alishchytovych,1,0.00142,6148,8.69971,70669
485,Allda,1,0.00142,6149,8.70113,70669
486,andonovj,1,0.00142,6150,8.70254,70669
487,Andrew1988123123,1,0.00142,6151,8.70396,70669
488,andy-vm,1,0.00142,6152,8.70537,70669
489,anikoo-nr,1,0.00142,6153,8.70679,70669
490,anmoln4,1,0.00142,6154,8.70820,70669
491,AnushaY1916,1,0.00142,6155,8.70962,70669
492,apavarnitsyn,1,0.00142,6156,8.71103,70669
493,apgapg,1,0.00142,6157,8.71245,70669
494,apjoseph,1,0.00142,6158,8.71386,70669
495,aroundthfur,1,0.00142,6159,8.71528,70669
496,arthurgeek,1,0.00142,6160,8.71669,70669
497,AruPersia,1,0.00142,6161,8.71811,70669
498,ashokks80,1,0.00142,6162,8.71952,70669
499,atanev,1,0.00142,6163,8.72094,70669
500,audunsol,1,0.00142,6164,8.72235,70669
501,AustralEpitech,1,0.00142,6165,8.72377,70669
502,awoimbee,1,0.00142,6166,8.72518,70669
503,BalaMuralibi,1,0.00142,6167,8.72660,70669
504,barthalion,1,0.00142,6168,8.72801,70669
505,bb-transpower,1,0.00142,6169,8.72943,70669
506,bennylut,1,0.00142,6170,8.73084,70669
507,bensonyerima,1,0.00142,6171,8.73226,70669
508,Berber31,1,0.00142,6172,8.73367,70669
509,bhagatdharmendra,1,0.00142,6173,8.73509,70669
510,bionaut,1,0.00142,6174,8.73650,70669
511,bitcloud,1,0.00142,6175,8.73792,70669
512,bittermandel,1,0.00142,6176,8.73933,70669
513,bjw-s,1,0.00142,6177,8.74075,70669
514,Blitss,1,0.00142,6178,8.74216,70669
515,BongoEADGC6,1,0.00142,6179,8.74358,70669
516,bornav,1,0.00142,6180,8.74499,70669
517,braunsonm,1,0.00142,6181,8.74641,70669
518,brettinternet,1,0.00142,6182,8.74782,70669
519,bryanwieg,1,0.00142,6183,8.74924,70669
520,bsnabil,1,0.00142,6184,8.75065,70669
521,cameronraysmith,1,0.00142,6185,8.75207,70669
522,carlosrmendes,1,0.00142,6186,8.75348,70669
523,CasLubbers,1,0.00142,6187,8.75490,70669
524,cccsss01,1,0.00142,6188,8.75631,70669
525,cchen-vertica,1,0.00142,6189,8.75773,70669
526,ccrvlh,1,0.00142,6190,8.75914,70669
527,cdxker,1,0.00142,6191,8.76056,70669
528,charank922,1,0.00142,6192,8.76197,70669
529,chrede88,1,0.00142,6193,8.76339,70669
530,cnolick,1,0.00142,6194,8.76480,70669
531,codelite7,1,0.00142,6195,8.76622,70669
532,codestation,1,0.00142,6196,8.76764,70669
533,ComaVN,1,0.00142,6197,8.76905,70669
534,CommanderStorm,1,0.00142,6198,8.77047,70669
535,cook1emr,1,0.00142,6199,8.77188,70669
536,coolguy1771,1,0.00142,6200,8.77330,70669
537,corentingiraud,1,0.00142,6201,8.77471,70669
538,costigator,1,0.00142,6202,8.77613,70669
539,covert8,1,0.00142,6203,8.77754,70669
540,c-thiel,1,0.00142,6204,8.77896,70669
541,cybercoder,1,0.00142,6205,8.78037,70669
542,dakine1111,1,0.00142,6206,8.78179,70669
543,danieljkemp,1,0.00142,6207,8.78320,70669
544,danielwestermann,1,0.00142,6208,8.78462,70669
545,danpker,1,0.00142,6209,8.78603,70669
546,darktempla,1,0.00142,6210,8.78745,70669
547,datamattsson,1,0.00142,6211,8.78886,70669
548,David-Angel,1,0.00142,6212,8.79028,70669
549,david-curran-90,1,0.00142,6213,8.79169,70669
550,davidpechcz,1,0.00142,6214,8.79311,70669
551,davidradl,1,0.00142,6215,8.79452,70669
552,dbaasvc,1,0.00142,6216,8.79594,70669
553,dba-git,1,0.00142,6217,8.79735,70669
554,debjitk,1,0.00142,6218,8.79877,70669
555,Denton-L,1,0.00142,6219,8.80018,70669
556,DeskPlant,1,0.00142,6220,8.80160,70669
557,diogotorres97,1,0.00142,6221,8.80301,70669
558,ditpoo,1,0.00142,6222,8.80443,70669
559,dmaclaury,1,0.00142,6223,8.80584,70669
560,dmpe,1,0.00142,6224,8.80726,70669
561,dream4r1,1,0.00142,6225,8.80867,70669
562,drew9781,1,0.00142,6226,8.81009,70669
563,dsessler7,1,0.00142,6227,8.81150,70669
564,DutchGerman,1,0.00142,6228,8.81292,70669
565,dynapps,1,0.00142,6229,8.81433,70669
566,EBMBA,1,0.00142,6230,8.81575,70669
567,ebodlli93,1,0.00142,6231,8.81716,70669
568,eduscrakozabrus,1,0.00142,6232,8.81858,70669
569,egkristi,1,0.00142,6233,8.81999,70669
570,elagree,1,0.00142,6234,8.82141,70669
571,elmerbulthuis,1,0.00142,6235,8.82282,70669
572,Elsayed91,1,0.00142,6236,8.82424,70669
573,emagiz,1,0.00142,6237,8.82565,70669
574,enrico-lumini,1,0.00142,6238,8.82707,70669
575,Enry58,1,0.00142,6239,8.82848,70669
576,ensdhvi,1,0.00142,6240,8.82990,70669
577,eolouw,1,0.00142,6241,8.83131,70669
578,eryalito,1,0.00142,6242,8.83273,70669
579,esakarya,1,0.00142,6243,8.83414,70669
580,eshikhov,1,0.00142,6244,8.83556,70669
581,evilhamsterman,1,0.00142,6245,8.83697,70669
582,facchettos,1,0.00142,6246,8.83839,70669
583,FacundoAcevedo,1,0.00142,6247,8.83980,70669
584,fakeNews-jpg,1,0.00142,6248,8.84122,70669
585,fanny-jiang,1,0.00142,6249,8.84263,70669
586,felixscheinost,1,0.00142,6250,8.84405,70669
587,fhoekstra,1,0.00142,6251,8.84546,70669
588,FilipZobic,1,0.00142,6252,8.84688,70669
589,firstdorsal,1,0.00142,6253,8.84829,70669
590,fkaempfer,1,0.00142,6254,8.84971,70669
591,flexusjan,1,0.00142,6255,8.85112,70669
592,Flybro,1,0.00142,6256,8.85254,70669
593,fm4991,1,0.00142,6257,8.85395,70669
594,Foosvald,1,0.00142,6258,8.85537,70669
595,fr6nco,1,0.00142,6259,8.85678,70669
596,fredkanye,1,0.00142,6260,8.85820,70669
597,freyes,1,0.00142,6261,8.85961,70669
598,fuqi1001,1,0.00142,6262,8.86103,70669
599,garribas-atlassian,1,0.00142,6263,8.86244,70669
600,gazab,1,0.00142,6264,8.86386,70669
601,Gazza7205,1,0.00142,6265,8.86527,70669
602,geanttechnology,1,0.00142,6266,8.86669,70669
603,geraldoandradee,1,0.00142,6267,8.86810,70669
604,ghormoon,1,0.00142,6268,8.86952,70669
605,gioppoluca,1,0.00142,6269,8.87093,70669
606,gitarns,1,0.00142,6270,8.87235,70669
607,glehmann,1,0.00142,6271,8.87376,70669
608,glesperance,1,0.00142,6272,8.87518,70669
609,gmatej,1,0.00142,6273,8.87659,70669
610,Goutman-afk,1,0.00142,6274,8.87801,70669
611,gppmilicia,1,0.00142,6275,8.87942,70669
612,grafanabot,1,0.00142,6276,8.88084,70669
613,Grubla,1,0.00142,6277,8.88225,70669
614,gsreg,1,0.00142,6278,8.88367,70669
615,h0jeZvgoxFepBQ2C,1,0.00142,6279,8.88508,70669
616,h3mmy,1,0.00142,6280,8.88650,70669
617,hakro,1,0.00142,6281,8.88791,70669
618,Harsesis89,1,0.00142,6282,8.88933,70669
619,Hashdhi,1,0.00142,6283,8.89074,70669
620,hashmap-kz,1,0.00142,6284,8.89216,70669
621,hei829,1,0.00142,6285,8.89357,70669
622,HendrikLevering,1,0.00142,6286,8.89499,70669
623,henro001,1,0.00142,6287,8.89640,70669
624,hopkinsjason,1,0.00142,6288,8.89782,70669
625,hsjarbin,1,0.00142,6289,8.89923,70669
626,iamrishav,1,0.00142,6290,8.90065,70669
627,igibek,1,0.00142,6291,8.90206,70669
628,igor-nikiforov,1,0.00142,6292,8.90348,70669
629,ilabrovic,1,0.00142,6293,8.90489,70669
630,ilanssari,1,0.00142,6294,8.90631,70669
631,IlonkaO,1,0.00142,6295,8.90772,70669
632,ImSingee,1,0.00142,6296,8.90914,70669
633,Inrixia,1,0.00142,6297,8.91055,70669
634,ironytr,1,0.00142,6298,8.91197,70669
635,itboy87,1,0.00142,6299,8.91338,70669
636,ivanwel,1,0.00142,6300,8.91480,70669
637,JakobStadlhuber,1,0.00142,6301,8.91622,70669
638,jamesandariese,1,0.00142,6302,8.91763,70669
639,JanKarremans666,1,0.00142,6303,8.91905,70669
640,JasonGao180,1,0.00142,6304,8.92046,70669
641,jawebada,1,0.00142,6305,8.92188,70669
642,jfrconley,1,0.00142,6306,8.92329,70669
643,JJacobuss,1,0.00142,6307,8.92471,70669
644,jlewandowski-lmco,1,0.00142,6308,8.92612,70669
645,jlimai,1,0.00142,6309,8.92754,70669
646,jmcorne,1,0.00142,6310,8.92895,70669
647,JMelatyar,1,0.00142,6311,8.93037,70669
648,jngrb,1,0.00142,6312,8.93178,70669
649,jocutajar,1,0.00142,6313,8.93320,70669
650,joekrill,1,0.00142,6314,8.93461,70669
651,JonasHess,1,0.00142,6315,8.93603,70669
652,jonaszlasut,1,0.00142,6316,8.93744,70669
653,jonsch318,1,0.00142,6317,8.93886,70669
654,jordi-t,1,0.00142,6318,8.94027,70669
655,jorgebsa,1,0.00142,6319,8.94169,70669
656,jorgephiguera,1,0.00142,6320,8.94310,70669
657,jtackaberry,1,0.00142,6321,8.94452,70669
658,JulienVall3,1,0.00142,6322,8.94593,70669
659,JustinLex,1,0.00142,6323,8.94735,70669
660,justinwyer,1,0.00142,6324,8.94876,70669
661,jvoss,1,0.00142,6325,8.95018,70669
662,jzkinetic,1,0.00142,6326,8.95159,70669
663,karlbaumg,1,0.00142,6327,8.95301,70669
664,Kevinckli,1,0.00142,6328,8.95442,70669
665,kgrimsby,1,0.00142,6329,8.95584,70669
666,khewonc,1,0.00142,6330,8.95725,70669
667,kkoppel,1,0.00142,6331,8.95867,70669
668,kokorousaki,1,0.00142,6332,8.96008,70669
669,krishnaGajabi,1,0.00142,6333,8.96150,70669
670,krs2k,1,0.00142,6334,8.96291,70669
671,kuism,1,0.00142,6335,8.96433,70669
672,L1ghtman2k,1,0.00142,6336,8.96574,70669
673,laibe,1,0.00142,6337,8.96716,70669
674,laukik85,1,0.00142,6338,8.96857,70669
675,lavanyaj3,1,0.00142,6339,8.96999,70669
676,leandrorosa,1,0.00142,6340,8.97140,70669
677,LemonDouble,1,0.00142,6341,8.97282,70669
678,lenaxia,1,0.00142,6342,8.97423,70669
679,lenow55,1,0.00142,6343,8.97565,70669
680,leverege-jphelps,1,0.00142,6344,8.97706,70669
681,levissfuture,1,0.00142,6345,8.97848,70669
682,LewisKSaint,1,0.00142,6346,8.97989,70669
683,LexZet,1,0.00142,6347,8.98131,70669
684,lilambivert,1,0.00142,6348,8.98272,70669
685,lmocofan,1,0.00142,6349,8.98414,70669
686,localbubble,1,0.00142,6350,8.98555,70669
687,lodnert,1,0.00142,6351,8.98697,70669
688,logan-broit,1,0.00142,6352,8.98838,70669
689,loktionovam,1,0.00142,6353,8.98980,70669
690,lrojas89,1,0.00142,6354,8.99121,70669
691,lsierant,1,0.00142,6355,8.99263,70669
692,ludat,1,0.00142,6356,8.99404,70669
693,Lyuven,1,0.00142,6357,8.99546,70669
694,m00nyONE,1,0.00142,6358,8.99687,70669
695,Marcel-Jansen,1,0.00142,6359,8.99829,70669
696,marcossv9,1,0.00142,6360,8.99970,70669
697,mark-webster-catalyst,1,0.00142,6361,9.00112,70669
698,markwebsterUK,1,0.00142,6362,9.00253,70669
699,marrip,1,0.00142,6363,9.00395,70669
700,marvinWolff,1,0.00142,6364,9.00536,70669
701,maslosan,1,0.00142,6365,9.00678,70669
702,MathCharton,1,0.00142,6366,9.00819,70669
703,ma-ts,1,0.00142,6367,9.00961,70669
704,matthijsvdr,1,0.00142,6368,9.01102,70669
705,mauza,1,0.00142,6369,9.01244,70669
706,maxcoolmakarov,1,0.00142,6370,9.01385,70669
707,maxgruber19,1,0.00142,6371,9.01527,70669
708,maxweisspoker,1,0.00142,6372,9.01668,70669
709,Mbaey,1,0.00142,6373,9.01810,70669
710,mblp,1,0.00142,6374,9.01951,70669
711,mboncalo,1,0.00142,6375,9.02093,70669
712,mehrdadbn9,1,0.00142,6376,9.02234,70669
713,melquisedequecosta98,1,0.00142,6377,9.02376,70669
714,meltingrock,1,0.00142,6378,9.02517,70669
715,mercuryyy,1,0.00142,6379,9.02659,70669
716,mfmessaoudi,1,0.00142,6380,9.02800,70669
717,mhammoudoddo,1,0.00142,6381,9.02942,70669
718,mheijkant,1,0.00142,6382,9.03083,70669
719,miguelfbrito,1,0.00142,6383,9.03225,70669
720,miguellords,1,0.00142,6384,9.03366,70669
721,mikart143,1,0.00142,6385,9.03508,70669
722,mindthecap,1,0.00142,6386,9.03649,70669
723,mingsterism,1,0.00142,6387,9.03791,70669
724,MKH-Beldi,1,0.00142,6388,9.03932,70669
725,mliker,1,0.00142,6389,9.04074,70669
726,mmeier86,1,0.00142,6390,9.04215,70669
727,moelhoussein,1,0.00142,6391,9.04357,70669
728,MonolithProjects,1,0.00142,6392,9.04498,70669
729,mporrato,1,0.00142,6393,9.04640,70669
730,mpsOxygen,1,0.00142,6394,9.04781,70669
731,mrlhansen,1,0.00142,6395,9.04923,70669
732,mshkpchv,1,0.00142,6396,9.05064,70669
733,msijmons,1,0.00142,6397,9.05206,70669
734,mzhaase,1,0.00142,6398,9.05347,70669
735,n-able-consulting,1,0.00142,6399,9.05489,70669
736,nachi-netskope,1,0.00142,6400,9.05630,70669
737,nbraun,1,0.00142,6401,9.05772,70669
738,NeverW8,1,0.00142,6402,9.05913,70669
739,nielsweistra,1,0.00142,6403,9.06055,70669
740,nishtha-srivastava-edb,1,0.00142,6404,9.06196,70669
741,nitinpatil-edb,1,0.00142,6405,9.06338,70669
742,nitishchauhan0022,1,0.00142,6406,9.06480,70669
743,nmarukovich,1,0.00142,6407,9.06621,70669
744,nogweii,1,0.00142,6408,9.06763,70669
745,ntx-ben,1,0.00142,6409,9.06904,70669
746,nurbek-workfindme,1,0.00142,6410,9.07046,70669
747,NWBY,1,0.00142,6411,9.07187,70669
748,olivergregorius,1,0.00142,6412,9.07329,70669
749,ondrej-smola,1,0.00142,6413,9.07470,70669
750,oprimogus,1,0.00142,6414,9.07612,70669
751,oscgu,1,0.00142,6415,9.07753,70669
752,osklil,1,0.00142,6416,9.07895,70669
753,osnabrugge,1,0.00142,6417,9.08036,70669
754,os-sengel,1,0.00142,6418,9.08178,70669
755,palekseym,1,0.00142,6419,9.08319,70669
756,Pandry,1,0.00142,6420,9.08461,70669
757,panigs7,1,0.00142,6421,9.08602,70669
758,pankaj-band12,1,0.00142,6422,9.08744,70669
759,paoloyx,1,0.00142,6423,9.08885,70669
760,PatrickRogg,1,0.00142,6424,9.09027,70669
761,pavaneeshwar7077,1,0.00142,6425,9.09168,70669
762,peem5210,1,0.00142,6426,9.09310,70669
763,pepinno,1,0.00142,6427,9.09451,70669
764,pheianox,1,0.00142,6428,9.09593,70669
765,pierreblais,1,0.00142,6429,9.09734,70669
766,pjsinka,1,0.00142,6430,9.09876,70669
767,pkehling-IAV,1,0.00142,6431,9.10017,70669
768,pkutakovvk,1,0.00142,6432,9.10159,70669
769,pmontagna,1,0.00142,6433,9.10300,70669
770,ppiont,1,0.00142,6434,9.10442,70669
771,Preisschild,1,0.00142,6435,9.10583,70669
772,Protryon,1,0.00142,6436,9.10725,70669
773,psychonic,1,0.00142,6437,9.10866,70669
774,pushkargr,1,0.00142,6438,9.11008,70669
775,Pwdak,1,0.00142,6439,9.11149,70669
776,pzeinlinger,1,0.00142,6440,9.11291,70669
777,qiliq,1,0.00142,6441,9.11432,70669
778,qlqw233,1,0.00142,6442,9.11574,70669
779,r0b1ndot,1,0.00142,6443,9.11715,70669
780,radhupr,1,0.00142,6444,9.11857,70669
781,rajramo61,1,0.00142,6445,9.11998,70669
782,ramijebara,1,0.00142,6446,9.12140,70669
783,retrogaming457,1,0.00142,6447,9.12281,70669
784,rg-ctrl,1,0.00142,6448,9.12423,70669
785,RickVenema,1,0.00142,6449,9.12564,70669
786,ricrug,1,0.00142,6450,9.12706,70669
787,riddhithummar,1,0.00142,6451,9.12847,70669
788,rishinair11,1,0.00142,6452,9.12989,70669
789,Ritikaram1,1,0.00142,6453,9.13130,70669
790,rkthtrifork,1,0.00142,6454,9.13272,70669
791,rlevytskyi,1,0.00142,6455,9.13413,70669
792,rmoreas,1,0.00142,6456,9.13555,70669
793,robasp,1,0.00142,6457,9.13696,70669
794,robcio-ops,1,0.00142,6458,9.13838,70669
795,robcxyz,1,0.00142,6459,9.13979,70669
796,robinvanderknaap,1,0.00142,6460,9.14121,70669
797,robinvanderstraeten-klarrio,1,0.00142,6461,9.14262,70669
798,rohanjayaraj,1,0.00142,6462,9.14404,70669
799,rophy,1,0.00142,6463,9.14545,70669
800,rosaldo260,1,0.00142,6464,9.14687,70669
801,rubasace,1,0.00142,6465,9.14828,70669
802,rubenz91,1,0.00142,6466,9.14970,70669
803,rvos-73,1,0.00142,6467,9.15111,70669
804,Ryder05,1,0.00142,6468,9.15253,70669
805,sajad-sadra,1,0.00142,6469,9.15394,70669
806,sajdakabir,1,0.00142,6470,9.15536,70669
807,salotz,1,0.00142,6471,9.15677,70669
808,SalvoRusso8,1,0.00142,6472,9.15819,70669
809,sambonbonne,1,0.00142,6473,9.15960,70669
810,sandert-k8s,1,0.00142,6474,9.16102,70669
811,sandroden,1,0.00142,6475,9.16243,70669
812,scotty00X,1,0.00142,6476,9.16385,70669
813,sebastianvoss,1,0.00142,6477,9.16526,70669
814,Sebor,1,0.00142,6478,9.16668,70669
815,semnell,1,0.00142,6479,9.16809,70669
816,serafdev,1,0.00142,6480,9.16951,70669
817,Sergey-Kirgizov,1,0.00142,6481,9.17092,70669
818,sergey-kudriavtsev,1,0.00142,6482,9.17234,70669
819,SergK,1,0.00142,6483,9.17375,70669
820,shajia-deshaw,1,0.00142,6484,9.17517,70669
821,sherlant,1,0.00142,6485,9.17658,70669
822,shiipou,1,0.00142,6486,9.17800,70669
823,shixuguang,1,0.00142,6487,9.17941,70669
824,ShonNahum,1,0.00142,6488,9.18083,70669
825,sigezhao,1,0.00142,6489,9.18224,70669
826,silanosa,1,0.00142,6490,9.18366,70669
827,silopolis,1,0.00142,6491,9.18507,70669
828,simardeep1792,1,0.00142,6492,9.18649,70669
829,simonebenati,1,0.00142,6493,9.18790,70669
830,simonebraga,1,0.00142,6494,9.18932,70669
831,simonmacklin,1,0.00142,6495,9.19073,70669
832,sle78,1,0.00142,6496,9.19215,70669
833,slickwilli,1,0.00142,6497,9.19356,70669
834,SmaineTF1,1,0.00142,6498,9.19498,70669
835,SNWCreations,1,0.00142,6499,9.19639,70669
836,soulaw-mkii,1,0.00142,6500,9.19781,70669
837,spantaleev,1,0.00142,6501,9.19922,70669
838,spresse1,1,0.00142,6502,9.20064,70669
839,sr12344321,1,0.00142,6503,9.20205,70669
840,sreisich,1,0.00142,6504,9.20347,70669
841,srijanshukla18,1,0.00142,6505,9.20488,70669
842,ssandur-thales,1,0.00142,6506,9.20630,70669
843,stavros-k,1,0.00142,6507,9.20771,70669
844,stefkkkk,1,0.00142,6508,9.20913,70669
845,steinwelberg,1,0.00142,6509,9.21054,70669
846,stephankoelle,1,0.00142,6510,9.21196,70669
847,SterlingJF,1,0.00142,6511,9.21338,70669
848,stilet,1,0.00142,6512,9.21479,70669
849,stone-z,1,0.00142,6513,9.21621,70669
850,strelok29,1,0.00142,6514,9.21762,70669
851,stsantilena,1,0.00142,6515,9.21904,70669
852,sud82,1,0.00142,6516,9.22045,70669
853,sudeepta88,1,0.00142,6517,9.22187,70669
854,szechyjs,1,0.00142,6518,9.22328,70669
855,T1mK,1,0.00142,6519,9.22470,70669
856,tanmayja,1,0.00142,6520,9.22611,70669
857,taraszka,1,0.00142,6521,9.22753,70669
858,Tautcius,1,0.00142,6522,9.22894,70669
859,TCBroad,1,0.00142,6523,9.23036,70669
860,tcraxs,1,0.00142,6524,9.23177,70669
861,TecIntelli,1,0.00142,6525,9.23319,70669
862,teeg82,1,0.00142,6526,9.23460,70669
863,teksuo,1,0.00142,6527,9.23602,70669
864,tgumleo,1,0.00142,6528,9.23743,70669
865,Th3Lourde,1,0.00142,6529,9.23885,70669
866,thatMacAdmin,1,0.00142,6530,9.24026,70669
867,thejordanclark,1,0.00142,6531,9.24168,70669
868,TheoBassaw,1,0.00142,6532,9.24309,70669
869,the-veloper,1,0.00142,6533,9.24451,70669
870,ThirVondukr,1,0.00142,6534,9.24592,70669
871,ThomasADavis,1,0.00142,6535,9.24734,70669
872,tim-brand,1,0.00142,6536,9.24875,70669
873,timothy-mullican,1,0.00142,6537,9.25017,70669
874,tjmoore4,1,0.00142,6538,9.25158,70669
875,tmsdce,1,0.00142,6539,9.25300,70669
876,toboshii,1,0.00142,6540,9.25441,70669
877,tom-asmblr,1,0.00142,6541,9.25583,70669
878,tomaszburdka-tomtom,1,0.00142,6542,9.25724,70669
879,tomaszkrzyzanowski,1,0.00142,6543,9.25866,70669
880,TomBillietKlarrio,1,0.00142,6544,9.26007,70669
881,tony-landreth,1,0.00142,6545,9.26149,70669
882,tothf,1,0.00142,6546,9.26290,70669
883,trublast,1,0.00142,6547,9.26432,70669
884,tschlaepfer,1,0.00142,6548,9.26573,70669
885,Tyagdit,1,0.00142,6549,9.26715,70669
886,ujala-singh,1,0.00142,6550,9.26856,70669
887,ujanssen,1,0.00142,6551,9.26998,70669
888,urashidmalik,1,0.00142,6552,9.27139,70669
889,urza,1,0.00142,6553,9.27281,70669
890,usanjeewa,1,0.00142,6554,9.27422,70669
891,vaiddas,1,0.00142,6555,9.27564,70669
892,Valefoth,1,0.00142,6556,9.27705,70669
893,vanyasvl,1,0.00142,6557,9.27847,70669
894,vasyakrg,1,0.00142,6558,9.27988,70669
895,vbezhenar,1,0.00142,6559,9.28130,70669
896,vicrem,1,0.00142,6560,9.28271,70669
897,vitorpavani,1,0.00142,6561,9.28413,70669
898,vongrad,1,0.00142,6562,9.28554,70669
899,vyruss,1,0.00142,6563,9.28696,70669
900,wadle,1,0.00142,6564,9.28837,70669
901,WalissonPires,1,0.00142,6565,9.28979,70669
902,wascript3r,1,0.00142,6566,9.29120,70669
903,Weihrauch,1,0.00142,6567,9.29262,70669
904,wesbragagt,1,0.00142,6568,9.29403,70669
905,WladyX,1,0.00142,6569,9.29545,70669
906,wolframm,1,0.00142,6570,9.29686,70669
907,wsp-git,1,0.00142,6571,9.29828,70669
908,xabufr,1,0.00142,6572,9.29969,70669
909,xenophenes,1,0.00142,6573,9.30111,70669
910,xiaolongkipsi,1,0.00142,6574,9.30252,70669
911,XLordalX,1,0.00142,6575,9.30394,70669
912,xnull,1,0.00142,6576,9.30535,70669
913,YentlFrickx,1,0.00142,6577,9.30677,70669
914,youngerwarrior,1,0.00142,6578,9.30818,70669
915,yremmet,1,0.00142,6579,9.30960,70669
916,yuriididuk89,1,0.00142,6580,9.31101,70669
917,yyvess,1,0.00142,6581,9.31243,70669
918,zaggash,1,0.00142,6582,9.31384,70669
919,Zeratoxx,1,0.00142,6583,9.31526,70669
920,zfy0701,1,0.00142,6584,9.31667,70669
