rank_number,actor,contributions,percent,cumulative_sum,cumulative_percent,all_contributions
1,sam-heilbron,12002,10.61936,12002,10.61936,113020
2,nfuden,6299,5.57335,18301,16.19271,113020
3,sheidkamp,3048,2.69687,21349,18.88958,113020
4,ben-taussig-solo,2735,2.41993,24084,21.30950,113020
5,Nadine2016,2644,2.33941,26728,23.64891,113020
6,bewebi,2542,2.24916,29270,25.89807,113020
7,marcogschmidt,1945,1.72093,31215,27.61901,113020
8,elcasteel,1814,1.60503,33029,29.22403,113020
9,gunnar-solo,1740,1.53955,34769,30.76358,113020
10,Bslabe123,1726,1.52716,36495,32.29075,113020
11,ashleywang1,1658,1.46700,38153,33.75774,113020
12,inFocus7,1539,1.36171,39692,35.11945,113020
13,arianaw66,1193,1.05557,40885,36.17501,113020
14,jackstine,1150,1.01752,42035,37.19253,113020
15,GrahamGoudeau,931,0.82375,42966,38.01628,113020
16,ianmacclancy,903,0.79897,43869,38.81525,113020
17,mlholland,812,0.71846,44681,39.53371,113020
18,ned1313,673,0.59547,45354,40.12918,113020
19,jameshbarton,606,0.53619,45960,40.66537,113020
20,chrisgaun,301,0.26632,46261,40.93169,113020
21,asayah,278,0.24597,46539,41.17767,113020
22,andy-fong,267,0.23624,46806,41.41391,113020
23,jmhbh,253,0.22385,47059,41.63776,113020
24,jehawley,237,0.20970,47296,41.84746,113020
25,mkazin,170,0.15042,47466,41.99788,113020
26,scranton,141,0.12476,47607,42.12263,113020
27,puertomontt,120,0.10618,47727,42.22881,113020
28,kcbabo,100,0.08848,47827,42.31729,113020
29,TomerJLevy,85,0.07521,47912,42.39250,113020
30,irateswami,79,0.06990,47991,42.46240,113020
31,cmwylie19,73,0.06459,48064,42.52699,113020
32,rpunia1,72,0.06371,48136,42.59069,113020
33,williamgrh,71,0.06282,48207,42.65351,113020
34,kdelorey,54,0.04778,48261,42.70129,113020
35,huzlak,51,0.04512,48312,42.74642,113020
36,snuggie12,51,0.04512,48363,42.79154,113020
37,jlourenc,49,0.04336,48412,42.83490,113020
38,AkshayAdsul,40,0.03539,48452,42.87029,113020
39,axhixh,40,0.03539,48492,42.90568,113020
40,anessi,39,0.03451,48531,42.94019,113020
41,f4z3r,35,0.03097,48566,42.97116,113020
42,pwoelfle,35,0.03097,48601,43.00212,113020
43,DoroNahari,33,0.02920,48634,43.03132,113020
44,debjitk,32,0.02831,48666,43.05964,113020
45,Kostavro,31,0.02743,48697,43.08706,113020
46,danfinn,28,0.02477,48725,43.11184,113020
47,andrzej-talarek,25,0.02212,48750,43.13396,113020
48,Cluas,24,0.02124,48774,43.15519,113020
49,DreyfussDaena,23,0.02035,48797,43.17554,113020
50,cryptomeme,22,0.01947,48819,43.19501,113020
51,jwilner,22,0.01947,48841,43.21448,113020
52,tmojlupo,21,0.01858,48862,43.23306,113020
53,fbuchmeier-abi,20,0.01770,48882,43.25075,113020
54,Krief,20,0.01770,48902,43.26845,113020
55,rpatel-repay,20,0.01770,48922,43.28614,113020
56,adityajalkhare,19,0.01681,48941,43.30296,113020
57,allenjol,19,0.01681,48960,43.31977,113020
58,Goend,19,0.01681,48979,43.33658,113020
59,jannes,19,0.01681,48998,43.35339,113020
60,sadieleob,19,0.01681,49017,43.37020,113020
61,scootweiss,19,0.01681,49036,43.38701,113020
62,sopida-chotwanwirach,19,0.01681,49055,43.40382,113020
63,Charlesthebird,18,0.01593,49073,43.41975,113020
64,gsustek,18,0.01593,49091,43.43568,113020
65,bgottfried91,17,0.01504,49108,43.45072,113020
66,Megum1n,17,0.01504,49125,43.46576,113020
67,mjaow,17,0.01504,49142,43.48080,113020
68,danielfablius,16,0.01416,49158,43.49496,113020
69,devkws,16,0.01416,49174,43.50911,113020
70,havard-fjaer,16,0.01416,49190,43.52327,113020
71,jaymiracola,16,0.01416,49206,43.53743,113020
72,Jimmmz,16,0.01416,49222,43.55158,113020
73,jmassasolo,16,0.01416,49238,43.56574,113020
74,ky-rafaels,16,0.01416,49254,43.57990,113020
75,ascampos,15,0.01327,49269,43.59317,113020
76,htech7x,15,0.01327,49284,43.60644,113020
77,NelsonJeppesen,15,0.01327,49299,43.61971,113020
78,laurentquillerou,14,0.01239,49313,43.63210,113020
79,SaffatHasan,13,0.01150,49326,43.64360,113020
80,Worfle,13,0.01150,49339,43.65511,113020
81,george-oakling,12,0.01062,49351,43.66572,113020
82,Harshad112,12,0.01062,49363,43.67634,113020
83,nickcaballero,12,0.01062,49375,43.68696,113020
84,orange-guo,12,0.01062,49387,43.69758,113020
85,pmichna,12,0.01062,49399,43.70819,113020
86,avizov,11,0.00973,49410,43.71793,113020
87,gektor0856,11,0.00973,49421,43.72766,113020
88,georgefridrich,11,0.00973,49432,43.73739,113020
89,ianrudie-tmus,11,0.00973,49443,43.74712,113020
90,Ido-Itz,11,0.00973,49454,43.75686,113020
91,iridian-ks,11,0.00973,49465,43.76659,113020
92,sandromlp,11,0.00973,49476,43.77632,113020
93,bharathnoddy,10,0.00885,49486,43.78517,113020
94,Implausiblyfun,10,0.00885,49496,43.79402,113020
95,lowkeyliesmyth,10,0.00885,49506,43.80287,113020
96,sbvitok,10,0.00885,49516,43.81171,113020
97,ably77,9,0.00796,49525,43.81968,113020
98,asloan7,9,0.00796,49534,43.82764,113020
99,bobzoller,9,0.00796,49543,43.83560,113020
100,byrdog55,9,0.00796,49552,43.84357,113020
101,lamadome,9,0.00796,49561,43.85153,113020
102,plorent,9,0.00796,49570,43.85949,113020
103,aku,8,0.00708,49578,43.86657,113020
104,amiramw,8,0.00708,49586,43.87365,113020
105,blackjid,8,0.00708,49594,43.88073,113020
106,crstamps2,8,0.00708,49602,43.88781,113020
107,Ericra95,8,0.00708,49610,43.89489,113020
108,fabioaraujopt,8,0.00708,49618,43.90196,113020
109,genslein,8,0.00708,49626,43.90904,113020
110,gigi-at-zymergen,8,0.00708,49634,43.91612,113020
111,JeremyBarbosa,8,0.00708,49642,43.92320,113020
112,malmanzor,8,0.00708,49650,43.93028,113020
113,mattchrist,8,0.00708,49658,43.93736,113020
114,ncouse,8,0.00708,49666,43.94443,113020
115,sirrapa,8,0.00708,49674,43.95151,113020
116,TheCubicleJockey,8,0.00708,49682,43.95859,113020
117,Vacant0mens,8,0.00708,49690,43.96567,113020
118,allthingssecurity,7,0.00619,49697,43.97186,113020
119,ashsolo,7,0.00619,49704,43.97806,113020
120,bensolo-io,7,0.00619,49711,43.98425,113020
121,dmurawsky,7,0.00619,49718,43.99044,113020
122,Ellioben,7,0.00619,49725,43.99664,113020
123,fmedery,7,0.00619,49732,44.00283,113020
124,jswinner09,7,0.00619,49739,44.00902,113020
125,keiransteele,7,0.00619,49746,44.01522,113020
126,lilley2412,7,0.00619,49753,44.02141,113020
127,mrManner,7,0.00619,49760,44.02761,113020
128,shahar-h,7,0.00619,49767,44.03380,113020
129,stevef1uk,7,0.00619,49774,44.03999,113020
130,stevejr,7,0.00619,49781,44.04619,113020
131,wwhwwxlz,7,0.00619,49788,44.05238,113020
132,ctomc,6,0.00531,49794,44.05769,113020
133,Dominik-K,6,0.00531,49800,44.06300,113020
134,efistokl,6,0.00531,49806,44.06831,113020
135,kkapelon,6,0.00531,49812,44.07362,113020
136,lmaillet,6,0.00531,49818,44.07892,113020
137,marcelsigner,6,0.00531,49824,44.08423,113020
138,PinchasLev,6,0.00531,49830,44.08954,113020
139,rustrial,6,0.00531,49836,44.09485,113020
140,sanadbar,6,0.00531,49842,44.10016,113020
141,twang11,6,0.00531,49848,44.10547,113020
142,unbreakab1e,6,0.00531,49854,44.11078,113020
143,wendeh,6,0.00531,49860,44.11609,113020
144,zamrokk,6,0.00531,49866,44.12139,113020
145,akitekt,5,0.00442,49871,44.12582,113020
146,cmars,5,0.00442,49876,44.13024,113020
147,cowboygneox,5,0.00442,49881,44.13467,113020
148,evsasha,5,0.00442,49886,44.13909,113020
149,mgolding5010,5,0.00442,49891,44.14351,113020
150,MikeSouza,5,0.00442,49896,44.14794,113020
151,nickschuetz,5,0.00442,49901,44.15236,113020
152,OcamsRazor,5,0.00442,49906,44.15679,113020
153,Paschi28,5,0.00442,49911,44.16121,113020
154,rbsrafa,5,0.00442,49916,44.16563,113020
155,spunuru,5,0.00442,49921,44.17006,113020
156,suyuee,5,0.00442,49926,44.17448,113020
157,techmunk,5,0.00442,49931,44.17891,113020
158,vladimir-cmd,5,0.00442,49936,44.18333,113020
159,washanhanzi,5,0.00442,49941,44.18775,113020
160,yorudy,5,0.00442,49946,44.19218,113020
161,a-b-v,4,0.00354,49950,44.19572,113020
162,AlexKaiserTK,4,0.00354,49954,44.19926,113020
163,amir3code,4,0.00354,49958,44.20280,113020
164,andreasph,4,0.00354,49962,44.20634,113020
165,Azahorscak,4,0.00354,49966,44.20987,113020
166,BeauSelisker28,4,0.00354,49970,44.21341,113020
167,bkuzmic,4,0.00354,49974,44.21695,113020
168,corporealshift,4,0.00354,49978,44.22049,113020
169,DaenaDreyfuss,4,0.00354,49982,44.22403,113020
170,DiegoLelis,4,0.00354,49986,44.22757,113020
171,fooeysadly,4,0.00354,49990,44.23111,113020
172,gaberger,4,0.00354,49994,44.23465,113020
173,jad-solo,4,0.00354,49998,44.23819,113020
174,juli-vert,4,0.00354,50002,44.24173,113020
175,mash-graz,4,0.00354,50006,44.24527,113020
176,pippitt,4,0.00354,50010,44.24881,113020
177,sjortiz,4,0.00354,50014,44.25234,113020
178,tayvs,4,0.00354,50018,44.25588,113020
179,Todai88,4,0.00354,50022,44.25942,113020
180,vipulagarwal,4,0.00354,50026,44.26296,113020
181,1026908346,3,0.00265,50029,44.26562,113020
182,abrahamTesfu,3,0.00265,50032,44.26827,113020
183,akhilaj,3,0.00265,50035,44.27093,113020
184,AlfredoFausto,3,0.00265,50038,44.27358,113020
185,AntoninCamus,3,0.00265,50041,44.27623,113020
186,begoat,3,0.00265,50044,44.27889,113020
187,c0debreaker,3,0.00265,50047,44.28154,113020
188,clemensk1,3,0.00265,50050,44.28420,113020
189,dereknex,3,0.00265,50053,44.28685,113020
190,dongsu,3,0.00265,50056,44.28951,113020
191,DraganDjuric94,3,0.00265,50059,44.29216,113020
192,ermakov-oleg,3,0.00265,50062,44.29482,113020
193,gilday,3,0.00265,50065,44.29747,113020
194,htpvu,3,0.00265,50068,44.30012,113020
195,ichtestemalwieder,3,0.00265,50071,44.30278,113020
196,jmcguire98,3,0.00265,50074,44.30543,113020
197,jonlane80,3,0.00265,50077,44.30809,113020
198,kahgeh,3,0.00265,50080,44.31074,113020
199,kuperiudazn,3,0.00265,50083,44.31340,113020
200,lancewf,3,0.00265,50086,44.31605,113020
201,linecolumn,3,0.00265,50089,44.31870,113020
202,MeghaGeo,3,0.00265,50092,44.32136,113020
203,omatsko,3,0.00265,50095,44.32401,113020
204,pandino,3,0.00265,50098,44.32667,113020
205,PanOS1,3,0.00265,50101,44.32932,113020
206,podilavenky,3,0.00265,50104,44.33198,113020
207,Rafeemp,3,0.00265,50107,44.33463,113020
208,rr-sarvesh-padia,3,0.00265,50110,44.33729,113020
209,sandrom,3,0.00265,50113,44.33994,113020
210,sebastian-popa,3,0.00265,50116,44.34259,113020
211,stevenpyzhang,3,0.00265,50119,44.34525,113020
212,subukris,3,0.00265,50122,44.34790,113020
213,suchisubhra,3,0.00265,50125,44.35056,113020
214,TheEvilCoder42,3,0.00265,50128,44.35321,113020
215,tiberiuac,3,0.00265,50131,44.35587,113020
216,tilgovi,3,0.00265,50134,44.35852,113020
217,tomer-epstein,3,0.00265,50137,44.36118,113020
218,tricky42,3,0.00265,50140,44.36383,113020
219,wtatum,3,0.00265,50143,44.36648,113020
220,zf-roose,3,0.00265,50146,44.36914,113020
221,zhonghuaxunGM,3,0.00265,50149,44.37179,113020
222,Akhil-ZF,2,0.00177,50151,44.37356,113020
223,alejandrocarlos,2,0.00177,50153,44.37533,113020
224,alfredo,2,0.00177,50155,44.37710,113020
225,andytruong,2,0.00177,50157,44.37887,113020
226,aqt01,2,0.00177,50159,44.38064,113020
227,arunprasadlv,2,0.00177,50161,44.38241,113020
228,asadoughi,2,0.00177,50163,44.38418,113020
229,chriskery,2,0.00177,50165,44.38595,113020
230,csabakollar,2,0.00177,50167,44.38772,113020
231,curuvija,2,0.00177,50169,44.38949,113020
232,dakamarko,2,0.00177,50171,44.39126,113020
233,daniel-sullivan,2,0.00177,50173,44.39303,113020
234,dinukxx,2,0.00177,50175,44.39480,113020
235,dinusha92,2,0.00177,50177,44.39657,113020
236,dmi3zkm,2,0.00177,50179,44.39834,113020
237,dpashkevich,2,0.00177,50181,44.40011,113020
238,earlsioson,2,0.00177,50183,44.40188,113020
239,eddiechihyi,2,0.00177,50185,44.40365,113020
240,emayssat,2,0.00177,50187,44.40541,113020
241,ericmand,2,0.00177,50189,44.40718,113020
242,fegbuka,2,0.00177,50191,44.40895,113020
243,hscheib,2,0.00177,50193,44.41072,113020
244,idogoren,2,0.00177,50195,44.41249,113020
245,jimmy-ho,2,0.00177,50197,44.41426,113020
246,Jingru,2,0.00177,50199,44.41603,113020
247,jjsadek,2,0.00177,50201,44.41780,113020
248,jwstack,2,0.00177,50203,44.41957,113020
249,kondasoulas,2,0.00177,50205,44.42134,113020
250,koturwaraditi,2,0.00177,50207,44.42311,113020
251,l30thelion,2,0.00177,50209,44.42488,113020
252,lmctest,2,0.00177,50211,44.42665,113020
253,luismiguelsaez-steercrm,2,0.00177,50213,44.42842,113020
254,luis-silva,2,0.00177,50215,44.43019,113020
255,mallikkml,2,0.00177,50217,44.43196,113020
256,MarkAtwood,2,0.00177,50219,44.43373,113020
257,mithie,2,0.00177,50221,44.43550,113020
258,mordabi,2,0.00177,50223,44.43727,113020
259,ncabanis,2,0.00177,50225,44.43904,113020
260,nikolasmatt,2,0.00177,50227,44.44081,113020
261,nilscan,2,0.00177,50229,44.44258,113020
262,pouledodue,2,0.00177,50231,44.44435,113020
263,prathyk,2,0.00177,50233,44.44612,113020
264,radenkoletic,2,0.00177,50235,44.44789,113020
265,raindev,2,0.00177,50237,44.44965,113020
266,salmanrafique-soloio,2,0.00177,50239,44.45142,113020
267,ShaunPTK,2,0.00177,50241,44.45319,113020
268,ShutUpLegs,2,0.00177,50243,44.45496,113020
269,solodamon,2,0.00177,50245,44.45673,113020
270,Spoonbender,2,0.00177,50247,44.45850,113020
271,stippi2,2,0.00177,50249,44.46027,113020
272,thebarshablog,2,0.00177,50251,44.46204,113020
273,TheMakboul,2,0.00177,50253,44.46381,113020
274,Thom-x,2,0.00177,50255,44.46558,113020
275,tmartinsolo,2,0.00177,50257,44.46735,113020
276,toreysoloio,2,0.00177,50259,44.46912,113020
277,TortleWortle,2,0.00177,50261,44.47089,113020
278,tylerle,2,0.00177,50263,44.47266,113020
279,Uf0k,2,0.00177,50265,44.47443,113020
280,vichanse,2,0.00177,50267,44.47620,113020
281,wsliu-talend,2,0.00177,50269,44.47797,113020
282,wyjwl,2,0.00177,50271,44.47974,113020
283,yarinisraeli24,2,0.00177,50273,44.48151,113020
284,ZF-fredericvanlinthoudt,2,0.00177,50275,44.48328,113020
285,zichul,2,0.00177,50277,44.48505,113020
286,zostay,2,0.00177,50279,44.48682,113020
287,205g0,1,0.00088,50280,44.48770,113020
288,4wdonny,1,0.00088,50281,44.48859,113020
289,90pizza,1,0.00088,50282,44.48947,113020
290,aaronArinder,1,0.00088,50283,44.49036,113020
291,abdoofathy95,1,0.00088,50284,44.49124,113020
292,AdarshNaidu,1,0.00088,50285,44.49213,113020
293,ahoze-r7,1,0.00088,50286,44.49301,113020
294,albsga,1,0.00088,50287,44.49389,113020
295,alexander-0077,1,0.00088,50288,44.49478,113020
296,alex-hempel,1,0.00088,50289,44.49566,113020
297,alex-mozejko,1,0.00088,50290,44.49655,113020
298,AlyssaBetty,1,0.00088,50291,44.49743,113020
299,amapi,1,0.00088,50292,44.49832,113020
300,AmerSelimovic,1,0.00088,50293,44.49920,113020
301,AnAnonymousFriend,1,0.00088,50294,44.50009,113020
302,andrewmelis,1,0.00088,50295,44.50097,113020
303,anshikavashistha,1,0.00088,50296,44.50186,113020
304,anus-ali,1,0.00088,50297,44.50274,113020
305,apobbati,1,0.00088,50298,44.50363,113020
306,apshaughnessy,1,0.00088,50299,44.50451,113020
307,araj-cloud,1,0.00088,50300,44.50540,113020
308,arctan90,1,0.00088,50301,44.50628,113020
309,armunro,1,0.00088,50302,44.50717,113020
310,aryaKetanWhjr1,1,0.00088,50303,44.50805,113020
311,asenyaev,1,0.00088,50304,44.50894,113020
312,aspacca,1,0.00088,50305,44.50982,113020
313,asthiago,1,0.00088,50306,44.51071,113020
314,bachirgit,1,0.00088,50307,44.51159,113020
315,base698,1,0.00088,50308,44.51248,113020
316,bazzuka,1,0.00088,50309,44.51336,113020
317,bdlilley,1,0.00088,50310,44.51425,113020
318,benallard,1,0.00088,50311,44.51513,113020
319,benhodgkiss,1,0.00088,50312,44.51601,113020
320,bgroupe,1,0.00088,50313,44.51690,113020
321,Bo98,1,0.00088,50314,44.51778,113020
322,BodhiHu,1,0.00088,50315,44.51867,113020
323,Boes-man,1,0.00088,50316,44.51955,113020
324,brianmares,1,0.00088,50317,44.52044,113020
325,CalebHenshaw,1,0.00088,50318,44.52132,113020
326,capiman13,1,0.00088,50319,44.52221,113020
327,cfx-cxd-cloudeng,1,0.00088,50320,44.52309,113020
328,chrisirhc,1,0.00088,50321,44.52398,113020
329,christophemorio,1,0.00088,50322,44.52486,113020
330,chtison,1,0.00088,50323,44.52575,113020
331,codepawpaw,1,0.00088,50324,44.52663,113020
332,crimbler2,1,0.00088,50325,44.52752,113020
333,daneah,1,0.00088,50326,44.52840,113020
334,DanijelaPet,1,0.00088,50327,44.52929,113020
335,dantodor,1,0.00088,50328,44.53017,113020
336,ddavoren,1,0.00088,50329,44.53106,113020
337,delta50,1,0.00088,50330,44.53194,113020
338,den-vasyliev,1,0.00088,50331,44.53283,113020
339,Dila333,1,0.00088,50332,44.53371,113020
340,dmaclaury,1,0.00088,50333,44.53460,113020
341,DraganDjuricOB,1,0.00088,50334,44.53548,113020
342,dseravalli,1,0.00088,50335,44.53637,113020
343,dspautz,1,0.00088,50336,44.53725,113020
344,dspe,1,0.00088,50337,44.53813,113020
345,eafxl,1,0.00088,50338,44.53902,113020
346,ediezh,1,0.00088,50339,44.53990,113020
347,ehdieunguyen,1,0.00088,50340,44.54079,113020
348,eko0126,1,0.00088,50341,44.54167,113020
349,elitegit,1,0.00088,50342,44.54256,113020
350,emily-ganze,1,0.00088,50343,44.54344,113020
351,ericnelson,1,0.00088,50344,44.54433,113020
352,evilezh,1,0.00088,50345,44.54521,113020
353,Ezinho031,1,0.00088,50346,44.54610,113020
354,flibustier7seas,1,0.00088,50347,44.54698,113020
355,fubinl,1,0.00088,50348,44.54787,113020
356,fxcoudert,1,0.00088,50349,44.54875,113020
357,gagemillerlob,1,0.00088,50350,44.54964,113020
358,galgro,1,0.00088,50351,44.55052,113020
359,geloizi,1,0.00088,50352,44.55141,113020
360,giridar-vmware,1,0.00088,50353,44.55229,113020
361,GitHub-Bryce,1,0.00088,50354,44.55318,113020
362,gk12277,1,0.00088,50355,44.55406,113020
363,graphex-sumo,1,0.00088,50356,44.55495,113020
364,GurdipS5,1,0.00088,50357,44.55583,113020
365,heatonmatthew,1,0.00088,50358,44.55672,113020
366,hengkuang777,1,0.00088,50359,44.55760,113020
367,heruscode,1,0.00088,50360,44.55849,113020
368,iisimaginary,1,0.00088,50361,44.55937,113020
369,imraulkays,1,0.00088,50362,44.56025,113020
370,isihu,1,0.00088,50363,44.56114,113020
371,itungnt,1,0.00088,50364,44.56202,113020
372,jamersonchequer,1,0.00088,50365,44.56291,113020
373,jameyhammock,1,0.00088,50366,44.56379,113020
374,jasonz3157,1,0.00088,50367,44.56468,113020
375,jehervy,1,0.00088,50368,44.56556,113020
376,JeremyRuffell,1,0.00088,50369,44.56645,113020
377,JING21,1,0.00088,50370,44.56733,113020
378,jjangga0214,1,0.00088,50371,44.56822,113020
379,jlewis42lines,1,0.00088,50372,44.56910,113020
380,jlore-talend,1,0.00088,50373,44.56999,113020
381,jmunoz19,1,0.00088,50374,44.57087,113020
382,jnsrikanth,1,0.00088,50375,44.57176,113020
383,joaomvalentim,1,0.00088,50376,44.57264,113020
384,joeruello,1,0.00088,50377,44.57353,113020
385,JohnHammet,1,0.00088,50378,44.57441,113020
386,jorgonzalez,1,0.00088,50379,44.57530,113020
387,JorjBauer,1,0.00088,50380,44.57618,113020
388,jshartar,1,0.00088,50381,44.57707,113020
389,JSkeats,1,0.00088,50382,44.57795,113020
390,justinpa-asg,1,0.00088,50383,44.57884,113020
391,jwvictor,1,0.00088,50384,44.57972,113020
392,k8so,1,0.00088,50385,44.58061,113020
393,kari-awake,1,0.00088,50386,44.58149,113020
394,KazChe,1,0.00088,50387,44.58237,113020
395,kdelisle-cs,1,0.00088,50388,44.58326,113020
396,kirin-13,1,0.00088,50389,44.58414,113020
397,KnechtionsCoding,1,0.00088,50390,44.58503,113020
398,kozy,1,0.00088,50391,44.58591,113020
399,krisMembeVia,1,0.00088,50392,44.58680,113020
400,kroniiii,1,0.00088,50393,44.58768,113020
401,kylecompassion,1,0.00088,50394,44.58857,113020
402,LevyTomer,1,0.00088,50395,44.58945,113020
403,LinMoskovitch,1,0.00088,50396,44.59034,113020
404,liorshami,1,0.00088,50397,44.59122,113020
405,lmakarov,1,0.00088,50398,44.59211,113020
406,loffelmacher,1,0.00088,50399,44.59299,113020
407,LorenzoFernando,1,0.00088,50400,44.59388,113020
408,LuisMalhadas,1,0.00088,50401,44.59476,113020
409,lzaldivarkt,1,0.00088,50402,44.59565,113020
410,Maduflavins,1,0.00088,50403,44.59653,113020
411,manuasir,1,0.00088,50404,44.59742,113020
412,mborho,1,0.00088,50405,44.59830,113020
413,mediakeys-platform,1,0.00088,50406,44.59919,113020
414,medva1997,1,0.00088,50407,44.60007,113020
415,megum1n,1,0.00088,50408,44.60096,113020
416,mercenaire,1,0.00088,50409,44.60184,113020
417,Metabdulla,1,0.00088,50410,44.60273,113020
418,mkarise,1,0.00088,50411,44.60361,113020
419,mmopenet,1,0.00088,50412,44.60449,113020
420,mohanchoudary,1,0.00088,50413,44.60538,113020
421,monotykamary,1,0.00088,50414,44.60626,113020
422,mordaby,1,0.00088,50415,44.60715,113020
423,MRodkin,1,0.00088,50416,44.60803,113020
424,mrsathis,1,0.00088,50417,44.60892,113020
425,mtritab,1,0.00088,50418,44.60980,113020
426,mwerickso,1,0.00088,50419,44.61069,113020
427,nagstaku,1,0.00088,50420,44.61157,113020
428,naimetti,1,0.00088,50421,44.61246,113020
429,natalefalco,1,0.00088,50422,44.61334,113020
430,nathan-vp,1,0.00088,50423,44.61423,113020
431,newtack,1,0.00088,50424,44.61511,113020
432,nguyendinhcatering,1,0.00088,50425,44.61600,113020
433,nickcodefresh,1,0.00088,50426,44.61688,113020
434,nickrobledo,1,0.00088,50427,44.61777,113020
435,nil-scan,1,0.00088,50428,44.61865,113020
436,nobject,1,0.00088,50429,44.61954,113020
437,nparry-zymergen,1,0.00088,50430,44.62042,113020
438,nr-dbuckwalter,1,0.00088,50431,44.62131,113020
439,nscherer-chipotle,1,0.00088,50432,44.62219,113020
440,ntx-ben,1,0.00088,50433,44.62308,113020
441,ohlmanjesse,1,0.00088,50434,44.62396,113020
442,omerdn1,1,0.00088,50435,44.62485,113020
443,OpenetCK,1,0.00088,50436,44.62573,113020
444,oschvr,1,0.00088,50437,44.62661,113020
445,OS-kiranmalsetty,1,0.00088,50438,44.62750,113020
446,ostmike,1,0.00088,50439,44.62838,113020
447,overbum,1,0.00088,50440,44.62927,113020
448,ovkhasch,1,0.00088,50441,44.63015,113020
449,pandarrr,1,0.00088,50442,44.63104,113020
450,pangorgo,1,0.00088,50443,44.63192,113020
451,paozhuanis1,1,0.00088,50444,44.63281,113020
452,pasdam,1,0.00088,50445,44.63369,113020
453,pawelaugustyn,1,0.00088,50446,44.63458,113020
454,Peelz,1,0.00088,50447,44.63546,113020
455,perrymckenzie,1,0.00088,50448,44.63635,113020
456,phillycheeze,1,0.00088,50449,44.63723,113020
457,Piotreqsl,1,0.00088,50450,44.63812,113020
458,prasanth-openet,1,0.00088,50451,44.63900,113020
459,prithvikavuri,1,0.00088,50452,44.63989,113020
460,prodion23,1,0.00088,50453,44.64077,113020
461,pruggera,1,0.00088,50454,44.64166,113020
462,pvrdatadome,1,0.00088,50455,44.64254,113020
463,qikijames,1,0.00088,50456,44.64343,113020
464,RaphaelKellerAdc,1,0.00088,50457,44.64431,113020
465,ReViTello,1,0.00088,50458,44.64520,113020
466,rezagh,1,0.00088,50459,44.64608,113020
467,rezagh2,1,0.00088,50460,44.64697,113020
468,richardpringle,1,0.00088,50461,44.64785,113020
469,riverlee2014,1,0.00088,50462,44.64873,113020
470,RorisangSitoboli,1,0.00088,50463,44.64962,113020
471,ryanisfluffy,1,0.00088,50464,44.65050,113020
472,sabrinasultan,1,0.00088,50465,44.65139,113020
473,sailinnthu,1,0.00088,50466,44.65227,113020
474,sauber,1,0.00088,50467,44.65316,113020
475,scags9876,1,0.00088,50468,44.65404,113020
476,scrocquesel,1,0.00088,50469,44.65493,113020
477,shiftyp,1,0.00088,50470,44.65581,113020
478,shreyasrama,1,0.00088,50471,44.65670,113020
479,soraliu,1,0.00088,50472,44.65758,113020
480,Stefan-Balta,1,0.00088,50473,44.65847,113020
481,stelucz,1,0.00088,50474,44.65935,113020
482,sundarseswaran,1,0.00088,50475,44.66024,113020
483,supalp,1,0.00088,50476,44.66112,113020
484,supasteev0,1,0.00088,50477,44.66201,113020
485,tb438,1,0.00088,50478,44.66289,113020
486,TendonT52,1,0.00088,50479,44.66378,113020
487,thesse1,1,0.00088,50480,44.66466,113020
488,tnguyen-lh,1,0.00088,50481,44.66555,113020
489,toddkazakov,1,0.00088,50482,44.66643,113020
490,togdon,1,0.00088,50483,44.66732,113020
491,TommyM,1,0.00088,50484,44.66820,113020
492,tony-Ma-yami,1,0.00088,50485,44.66909,113020
493,totiz,1,0.00088,50486,44.66997,113020
494,totovelo10,1,0.00088,50487,44.67085,113020
495,t-radhakrishnan,1,0.00088,50488,44.67174,113020
496,Tushar240503,1,0.00088,50489,44.67262,113020
497,twolf-adc,1,0.00088,50490,44.67351,113020
498,Tyzanol,1,0.00088,50491,44.67439,113020
499,urbanenomad,1,0.00088,50492,44.67528,113020
500,vicpl,1,0.00088,50493,44.67616,113020
501,vijayk108,1,0.00088,50494,44.67705,113020
502,vikrant82,1,0.00088,50495,44.67793,113020
503,vivekyad4v,1,0.00088,50496,44.67882,113020
504,vkarunx,1,0.00088,50497,44.67970,113020
505,vmarlier,1,0.00088,50498,44.68059,113020
506,vstrizaks,1,0.00088,50499,44.68147,113020
507,We-NutCracker,1,0.00088,50500,44.68236,113020
508,WonderPanda,1,0.00088,50501,44.68324,113020
509,xbaun,1,0.00088,50502,44.68413,113020
510,xkcp0324,1,0.00088,50503,44.68501,113020
511,xuanlinhha,1,0.00088,50504,44.68590,113020
512,xuhui-lu,1,0.00088,50505,44.68678,113020
513,yakketyyak,1,0.00088,50506,44.68767,113020
514,yanivNaor92,1,0.00088,50507,44.68855,113020
515,z0lope0z,1,0.00088,50508,44.68944,113020
516,zouxu09,1,0.00088,50509,44.69032,113020
