rank_number,actor,contributions,percent,cumulative_sum,cumulative_percent,all_contributions
1,opentofu-provider-sync-service-account,6497,11.72109,6497,11.72109,55430
2,cam72cam,6186,11.16002,12683,22.88111,55430
3,Yantrio,3639,6.56504,16322,29.44615,55430
4,ollevche,2420,4.36587,18742,33.81202,55430
5,cube2222,2042,3.68393,20784,37.49594,55430
6,modular-magician,2012,3.62980,22796,41.12574,55430
7,janosdebugs,1839,3.31770,24635,44.44344,55430
8,apparentlymart,1834,3.30868,26469,47.75212,55430
9,yottta,1260,2.27314,27729,50.02526,55430
10,mbialon,1235,2.22804,28964,52.25329,55430
11,DicsyDel,1132,2.04222,30096,54.29551,55430
12,RLRabinowitz,1047,1.88887,31143,56.18438,55430
13,Evi1Pumpkin,946,1.70666,32089,57.89103,55430
14,diofeher,919,1.65795,33008,59.54898,55430
15,flavius-dinu,898,1.62006,33906,61.16904,55430
16,eranelbaz,793,1.43063,34699,62.59968,55430
17,kislerdm,676,1.21956,35375,63.81923,55430
18,damianstasik,508,0.91647,35883,64.73570,55430
19,omry-hay,483,0.87137,36366,65.60707,55430
20,Gogotchuri,452,0.81544,36818,66.42251,55430
21,tomasmik,374,0.67472,37192,67.09724,55430
22,siddharthasonker95,330,0.59535,37522,67.69259,55430
23,jar-b,222,0.40051,37744,68.09309,55430
24,Andrew-Hayes,210,0.37886,37954,68.47195,55430
25,stephybun,191,0.34458,38145,68.81653,55430
26,katbyte,180,0.32473,38325,69.14126,55430
27,johnsonaj,166,0.29948,38491,69.44074,55430
28,yaronya,163,0.29406,38654,69.73480,55430
29,gdavison,161,0.29046,38815,70.02526,55430
30,aramilialon,151,0.27242,38966,70.29767,55430
31,YakDriver,146,0.26340,39112,70.56107,55430
32,SebastianStadil,142,0.25618,39254,70.81725,55430
33,brikis98,132,0.23814,39386,71.05539,55430
34,sanskruti-shahu,128,0.23092,39514,71.28631,55430
35,jackofallops,126,0.22731,39640,71.51362,55430
36,roni-frantchi,126,0.22731,39766,71.74093,55430
37,team-tf-cdk,118,0.21288,39884,71.95382,55430
38,catriona-m,115,0.20747,39999,72.16128,55430
39,hc-github-team-tf-provider-devex,112,0.20206,40111,72.36334,55430
40,skyzyx,107,0.19304,40218,72.55638,55430
41,austinvalle,101,0.18221,40319,72.73859,55430
42,Hefeweizen,99,0.17860,40418,72.91719,55430
43,abstractionfactory,97,0.17500,40515,73.09219,55430
44,FraneCaleta,95,0.17139,40610,73.26358,55430
45,Roma36,95,0.17139,40705,73.43496,55430
46,serdardalgic,94,0.16958,40799,73.60455,55430
47,chenzejun,88,0.15876,40887,73.76331,55430
48,justinretzolk,88,0.15876,40975,73.92206,55430
49,SypherSP,88,0.15876,41063,74.08082,55430
50,teowa,87,0.15695,41150,74.23778,55430
51,bunniseng,85,0.15335,41235,74.39112,55430
52,sinbai,82,0.14793,41317,74.53906,55430
53,acwwat,79,0.14252,41396,74.68158,55430
54,brandonc,77,0.13891,41473,74.82049,55430
55,Ericwww,77,0.13891,41550,74.95941,55430
56,mikelolasagasti,75,0.13531,41625,75.09471,55430
57,haiderbari,72,0.12989,41697,75.22461,55430
58,wuxu92,72,0.12989,41769,75.35450,55430
59,magodo,70,0.12629,41839,75.48079,55430
60,breathingdust,69,0.12448,41908,75.60527,55430
61,ms-henglu,68,0.12268,41976,75.72795,55430
62,namgyalangmo,66,0.11907,42042,75.84701,55430
63,eduzgun,65,0.11727,42107,75.96428,55430
64,ziyeqf,64,0.11546,42171,76.07974,55430
65,bflad,62,0.11185,42233,76.19159,55430
66,virtualroot,62,0.11185,42295,76.30345,55430
67,orbitz,61,0.11005,42356,76.41349,55430
68,StephanHCB,60,0.10824,42416,76.52174,55430
69,Kazzhar,59,0.10644,42475,76.62818,55430
70,alexott,55,0.09922,42530,76.72740,55430
71,IgnorantSapient,55,0.09922,42585,76.82663,55430
72,ipolyzos,55,0.09922,42640,76.92585,55430
73,mattburgess,54,0.09742,42694,77.02327,55430
74,sreallymatt,51,0.09201,42745,77.11528,55430
75,rumenvasilev,48,0.08660,42793,77.20188,55430
76,yhakbar,47,0.08479,42840,77.28667,55430
77,nitrocode,43,0.07758,42883,77.36424,55430
78,stefanfreitag,43,0.07758,42926,77.44182,55430
79,wojciech12,43,0.07758,42969,77.51939,55430
80,yindia,43,0.07758,43012,77.59697,55430
81,ImIOImI,41,0.07397,43053,77.67094,55430
82,melinath,41,0.07397,43094,77.74490,55430
83,jiaweitao001,40,0.07216,43134,77.81707,55430
84,Magnitus-,40,0.07216,43174,77.88923,55430
85,WodansSon,40,0.07216,43214,77.96139,55430
86,nam054,38,0.06855,43252,78.02995,55430
87,rdhar,38,0.06855,43290,78.09850,55430
88,Klopklopi,37,0.06675,43327,78.16525,55430
89,SarahFrench,37,0.06675,43364,78.23200,55430
90,DanielRieske,36,0.06495,43400,78.29695,55430
91,ms-zhenhua,36,0.06495,43436,78.36190,55430
92,josh-padnick,35,0.06314,43471,78.42504,55430
93,nikhil-goenka,35,0.06314,43506,78.48818,55430
94,oprudkyi,35,0.06314,43541,78.55133,55430
95,jamesgeddes,34,0.06134,43575,78.61266,55430
96,MatthewJohn,32,0.05773,43607,78.67040,55430
97,xiaxyi,29,0.05232,43636,78.72271,55430
98,AdosH1,28,0.05051,43664,78.77323,55430
99,drewtul,28,0.05051,43692,78.82374,55430
100,g0dfl3sh,28,0.05051,43720,78.87426,55430
101,RoseSecurity,27,0.04871,43747,78.92297,55430
102,tom-reinders,27,0.04871,43774,78.97168,55430
103,buraksenn,26,0.04691,43800,79.01858,55430
104,jasonpilz,26,0.04691,43826,79.06549,55430
105,l-with,26,0.04691,43852,79.11239,55430
106,Crandel,25,0.04510,43877,79.15750,55430
107,dkooll,25,0.04510,43902,79.20260,55430
108,liamcervante,25,0.04510,43927,79.24770,55430
109,liuwuliuyun,24,0.04330,43951,79.29100,55430
110,paulaustin-automutatio,24,0.04330,43975,79.33430,55430
111,pratikjain227,24,0.04330,43999,79.37759,55430
112,rileykarson,24,0.04330,44023,79.42089,55430
113,allofthesepeople,23,0.04149,44046,79.46238,55430
114,Ant0wan,23,0.04149,44069,79.50388,55430
115,MaxAnderson95,23,0.04149,44092,79.54537,55430
116,stoptofu1,23,0.04149,44115,79.58687,55430
117,alex067,22,0.03969,44137,79.62656,55430
118,ilmax,22,0.03969,44159,79.66625,55430
119,Jake-Mok-Nelson,22,0.03969,44181,79.70594,55430
120,ronnyorot,22,0.03969,44203,79.74563,55430
121,SBGoods,22,0.03969,44225,79.78531,55430
122,shuyama1,22,0.03969,44247,79.82500,55430
123,AYM1607,21,0.03789,44268,79.86289,55430
124,bbasata,21,0.03789,44289,79.90078,55430
125,kubrickfr,21,0.03789,44310,79.93866,55430
126,maunzCache,21,0.03789,44331,79.97655,55430
127,BBBmau,20,0.03608,44351,80.01263,55430
128,he0s,20,0.03608,44371,80.04871,55430
129,mm-chia,20,0.03608,44391,80.08479,55430
130,zhenrong-wang,20,0.03608,44411,80.12087,55430
131,zli82016,20,0.03608,44431,80.15695,55430
132,ait-vdykyi,19,0.03428,44450,80.19123,55430
133,bvand,19,0.03428,44469,80.22551,55430
134,ctrombley,19,0.03428,44488,80.25979,55430
135,edizsuleyman,19,0.03428,44507,80.29406,55430
136,marcosentino,19,0.03428,44526,80.32834,55430
137,notorand-it,19,0.03428,44545,80.36262,55430
138,wyattfry,19,0.03428,44564,80.39690,55430
139,adamconnelly,18,0.03247,44582,80.42937,55430
140,bruceharrison1984,18,0.03247,44600,80.46184,55430
141,Chambras,18,0.03247,44618,80.49432,55430
142,edualb,18,0.03247,44636,80.52679,55430
143,hqhqhqhqhqhqhqhqhqhqhq,18,0.03247,44654,80.55926,55430
144,mtarsel,18,0.03247,44672,80.59174,55430
145,ZIJ,18,0.03247,44690,80.62421,55430
146,JonasBak,17,0.03067,44707,80.65488,55430
147,maheshrjl,17,0.03067,44724,80.68555,55430
148,puneetsarna,17,0.03067,44741,80.71622,55430
149,Rajdeep1311,17,0.03067,44758,80.74689,55430
150,ravinitp,17,0.03067,44775,80.77756,55430
151,timofurrer,17,0.03067,44792,80.80823,55430
152,admito88,16,0.02887,44808,80.83709,55430
153,aidan-mundy,16,0.02887,44824,80.86596,55430
154,arunim2405,16,0.02887,44840,80.89482,55430
155,DrFaust92,16,0.02887,44856,80.92369,55430
156,eunanio,16,0.02887,44872,80.95255,55430
157,favoretti,16,0.02887,44888,80.98142,55430
158,jiawei-hong,16,0.02887,44904,81.01028,55430
159,jpitlor,16,0.02887,44920,81.03915,55430
160,kamilturek,16,0.02887,44936,81.06801,55430
161,kmgrime,16,0.02887,44952,81.09688,55430
162,MS99-9,16,0.02887,44968,81.12574,55430
163,oborys,16,0.02887,44984,81.15461,55430
164,dotemacs,15,0.02706,44999,81.18167,55430
165,jrasell,15,0.02706,45014,81.20873,55430
166,lettucemode,15,0.02706,45029,81.23579,55430
167,rusik69,15,0.02706,45044,81.26285,55430
168,tmccombs,15,0.02706,45059,81.28992,55430
169,xingjiu,15,0.02706,45074,81.31698,55430
170,alexhung,14,0.02526,45088,81.34223,55430
171,avorima,14,0.02526,45102,81.36749,55430
172,Cipher-08,14,0.02526,45116,81.39275,55430
173,denis256,14,0.02526,45130,81.41800,55430
174,faiwer,14,0.02526,45144,81.44326,55430
175,lonegunmanb,14,0.02526,45158,81.46852,55430
176,JDuskey,13,0.02345,45171,81.49197,55430
177,parrotmac,13,0.02345,45184,81.51542,55430
178,ProbstDJakob,13,0.02345,45197,81.53888,55430
179,roaks3,13,0.02345,45210,81.56233,55430
180,siegenthalerroger,13,0.02345,45223,81.58578,55430
181,stefanfreitagrwe,13,0.02345,45236,81.60924,55430
182,tabito-hara,13,0.02345,45249,81.63269,55430
183,tofuisnotopen,13,0.02345,45262,81.65614,55430
184,vtopc,13,0.02345,45275,81.67960,55430
185,7h3-3mp7y-m4n,12,0.02165,45287,81.70124,55430
186,boetro,12,0.02165,45299,81.72289,55430
187,JamesBalazs,12,0.02165,45311,81.74454,55430
188,minamijoyo,12,0.02165,45323,81.76619,55430
189,ohad1282,12,0.02165,45335,81.78784,55430
190,professorabhay,12,0.02165,45347,81.80949,55430
191,sjpb,12,0.02165,45359,81.83114,55430
192,ag-TJNII,11,0.01984,45370,81.85098,55430
193,drewmullen,11,0.01984,45381,81.87083,55430
194,hao-nan-li,11,0.01984,45392,81.89067,55430
195,luis-giraldo,11,0.01984,45403,81.91052,55430
196,markoskandylis,11,0.01984,45414,81.93036,55430
197,NathanBaulch,11,0.01984,45425,81.95021,55430
198,rainkwan,11,0.01984,45436,81.97005,55430
199,szepeviktor,11,0.01984,45447,81.98990,55430
200,tgmatt,11,0.01984,45458,82.00974,55430
201,ThomasZalewski,11,0.01984,45469,82.02959,55430
202,adyxax,10,0.01804,45479,82.04763,55430
203,asajaroff,10,0.01804,45489,82.06567,55430
204,baa-ableton,10,0.01804,45499,82.08371,55430
205,c-baumgartner,10,0.01804,45509,82.10175,55430
206,CorrenSoft,10,0.01804,45519,82.11979,55430
207,ddericco,10,0.01804,45529,82.13783,55430
208,desmaraisp,10,0.01804,45539,82.15587,55430
209,GlennChia,10,0.01804,45549,82.17391,55430
210,HenryEstberg,10,0.01804,45559,82.19195,55430
211,hrboyceiii,10,0.01804,45569,82.20999,55430
212,ianaya89,10,0.01804,45579,82.22804,55430
213,kdpuvvadi,10,0.01804,45589,82.24608,55430
214,littlejo,10,0.01804,45599,82.26412,55430
215,oWretch,10,0.01804,45609,82.28216,55430
216,pawelpiwosz,10,0.01804,45619,82.30020,55430
217,pranav-new-relic,10,0.01804,45629,82.31824,55430
218,rbeuque74,10,0.01804,45639,82.33628,55430
219,sashalarsoo,10,0.01804,45649,82.35432,55430
220,Shr3ps,10,0.01804,45659,82.37236,55430
221,SirGitsalot,10,0.01804,45669,82.39040,55430
222,slevenick,10,0.01804,45679,82.40844,55430
223,wellsiau-aws,10,0.01804,45689,82.42648,55430
224,ZachGoldberg,10,0.01804,45699,82.44452,55430
225,alexbacchin,9,0.01624,45708,82.46076,55430
226,ansgarm,9,0.01624,45717,82.47700,55430
227,Apollorion,9,0.01624,45726,82.49323,55430
228,atykhyy,9,0.01624,45735,82.50947,55430
229,binnsr,9,0.01624,45744,82.52571,55430
230,brano543,9,0.01624,45753,82.54194,55430
231,DavidGamba,9,0.01624,45762,82.55818,55430
232,efadeev,9,0.01624,45771,82.57442,55430
233,gmeligio,9,0.01624,45780,82.59065,55430
234,hainenber,9,0.01624,45789,82.60689,55430
235,hc-github-team-tf-azure,9,0.01624,45798,82.62313,55430
236,jessiepuls,9,0.01624,45807,82.63936,55430
237,jogarao96,9,0.01624,45816,82.65560,55430
238,nialdaly,9,0.01624,45825,82.67184,55430
239,nicolas-brousse,9,0.01624,45834,82.68808,55430
240,OYTAdmin,9,0.01624,45843,82.70431,55430
241,paladin-devops,9,0.01624,45852,82.72055,55430
242,pierluc-codes,9,0.01624,45861,82.73679,55430
243,RDhar,9,0.01624,45870,82.75302,55430
244,rpoovey,9,0.01624,45879,82.76926,55430
245,SaiCharanReddyAdla,9,0.01624,45888,82.78550,55430
246,Sirivasv,9,0.01624,45897,82.80173,55430
247,stooooptoooofu,9,0.01624,45906,82.81797,55430
248,tofustop,9,0.01624,45915,82.83421,55430
249,zekth,9,0.01624,45924,82.85044,55430
250,1garo,8,0.01443,45932,82.86487,55430
251,AchimGrolimund,8,0.01443,45940,82.87931,55430
252,aditya-tanwar,8,0.01443,45948,82.89374,55430
253,alexwilcox9,8,0.01443,45956,82.90817,55430
254,alwayshang,8,0.01443,45964,82.92261,55430
255,ansromanov,8,0.01443,45972,82.93704,55430
256,ASHR4,8,0.01443,45980,82.95147,55430
257,bendbennett,8,0.01443,45988,82.96590,55430
258,boaz0,8,0.01443,45996,82.98034,55430
259,danischm,8,0.01443,46004,82.99477,55430
260,davidjeddy,8,0.01443,46012,83.00920,55430
261,DenisBalan,8,0.01443,46020,83.02363,55430
262,eelhomsi,8,0.01443,46028,83.03807,55430
263,gberenice,8,0.01443,46036,83.05250,55430
264,jacobbednarz,8,0.01443,46044,83.06693,55430
265,janorn,8,0.01443,46052,83.08136,55430
266,jay-dee7,8,0.01443,46060,83.09580,55430
267,jeremy-albinet,8,0.01443,46068,83.11023,55430
268,joeybenamy,8,0.01443,46076,83.12466,55430
269,jsm222,8,0.01443,46084,83.13909,55430
270,keerthanamsys,8,0.01443,46092,83.15353,55430
271,ludoo,8,0.01443,46100,83.16796,55430
272,maksym-nazarenko,8,0.01443,46108,83.18239,55430
273,marziply,8,0.01443,46116,83.19682,55430
274,maxcoulombe,8,0.01443,46124,83.21126,55430
275,MaxOinRU,8,0.01443,46132,83.22569,55430
276,mehhhhhhhhhhhhhhh,8,0.01443,46140,83.24012,55430
277,rcskosir,8,0.01443,46148,83.25456,55430
278,Reckoner911,8,0.01443,46156,83.26899,55430
279,ScottSuarez,8,0.01443,46164,83.28342,55430
280,SkypLabs,8,0.01443,46172,83.29785,55430
281,surfingdoggo,8,0.01443,46180,83.31229,55430
282,thusfrancisco,8,0.01443,46188,83.32672,55430
283,tspearconquest,8,0.01443,46196,83.34115,55430
284,ZverGuy,8,0.01443,46204,83.35558,55430
285,alexknez,7,0.01263,46211,83.36821,55430
286,andrei-zededa,7,0.01263,46218,83.38084,55430
287,askadhum,7,0.01263,46225,83.39347,55430
288,barshopen,7,0.01263,46232,83.40610,55430
289,bpg,7,0.01263,46239,83.41873,55430
290,bubbletroubles,7,0.01263,46246,83.43135,55430
291,catlike,7,0.01263,46253,83.44398,55430
292,ChihweiLHBird,7,0.01263,46260,83.45661,55430
293,CodeBleu,7,0.01263,46267,83.46924,55430
294,david1437,7,0.01263,46274,83.48187,55430
295,dhuckins,7,0.01263,46281,83.49450,55430
296,dmikushin,7,0.01263,46288,83.50713,55430
297,dzakwanf,7,0.01263,46295,83.51975,55430
298,dzaytsev91,7,0.01263,46302,83.53238,55430
299,ednxzu,7,0.01263,46309,83.54501,55430
300,eunanhardy,7,0.01263,46316,83.55764,55430
301,gerrytan,7,0.01263,46323,83.57027,55430
302,hjoshi123,7,0.01263,46330,83.58290,55430
303,jinjiadu,7,0.01263,46337,83.59553,55430
304,joeaawad,7,0.01263,46344,83.60815,55430
305,Jyots6914,7,0.01263,46351,83.62078,55430
306,KenSpur,7,0.01263,46358,83.63341,55430
307,kill3r-queen,7,0.01263,46365,83.64604,55430
308,konradotto,7,0.01263,46372,83.65867,55430
309,loafoe,7,0.01263,46379,83.67130,55430
310,nikitabarskov,7,0.01263,46386,83.68393,55430
311,obounaim,7,0.01263,46393,83.69655,55430
312,peterdeme,7,0.01263,46400,83.70918,55430
313,pisarenko-net,7,0.01263,46407,83.72181,55430
314,robwittman,7,0.01263,46414,83.73444,55430
315,RubenMakandra,7,0.01263,46421,83.74707,55430
316,salyh,7,0.01263,46428,83.75970,55430
317,sandstrom,7,0.01263,46435,83.77233,55430
318,sasidhar-aws,7,0.01263,46442,83.78495,55430
319,skyf0l,7,0.01263,46449,83.79758,55430
320,SweetGeneral,7,0.01263,46456,83.81021,55430
321,thumperward,7,0.01263,46463,83.82284,55430
322,tony21921,7,0.01263,46470,83.83547,55430
323,TTTouper,7,0.01263,46477,83.84810,55430
324,urischeiner,7,0.01263,46484,83.86073,55430
325,xaptronic,7,0.01263,46491,83.87335,55430
326,111a5ab1,6,0.01082,46497,83.88418,55430
327,abentley-ssimwave,6,0.01082,46503,83.89500,55430
328,AdamTylerLynch,6,0.01082,46509,83.90583,55430
329,adv4000,6,0.01082,46515,83.91665,55430
330,Alladeila,6,0.01082,46521,83.92748,55430
331,allpoints,6,0.01082,46527,83.93830,55430
332,AmerAlkaki,6,0.01082,46533,83.94913,55430
333,Anush008,6,0.01082,46539,83.95995,55430
334,AsafZalcman,6,0.01082,46545,83.97077,55430
335,atorrescogollo,6,0.01082,46551,83.98160,55430
336,Babayevateran,6,0.01082,46557,83.99242,55430
337,BenjaminDecreusefond,6,0.01082,46563,84.00325,55430
338,c2thorn,6,0.01082,46569,84.01407,55430
339,Cadienvan,6,0.01082,46575,84.02490,55430
340,chopeen,6,0.01082,46581,84.03572,55430
341,chpl,6,0.01082,46587,84.04655,55430
342,Dennizz,6,0.01082,46593,84.05737,55430
343,dlaguerta,6,0.01082,46599,84.06819,55430
344,elacheche,6,0.01082,46605,84.07902,55430
345,eliastor,6,0.01082,46611,84.08984,55430
346,IanMoroney,6,0.01082,46617,84.10067,55430
347,itspngu,6,0.01082,46623,84.11149,55430
348,jaireddjawed,6,0.01082,46629,84.12232,55430
349,jasonwilson,6,0.01082,46635,84.13314,55430
350,jenia,6,0.01082,46641,84.14397,55430
351,jeremychauvet,6,0.01082,46647,84.15479,55430
352,jgalais,6,0.01082,46653,84.16561,55430
353,joshvito,6,0.01082,46659,84.17644,55430
354,kavan-aws,6,0.01082,46665,84.18726,55430
355,kazimierzbudzyk,6,0.01082,46671,84.19809,55430
356,lagerfeuer,6,0.01082,46677,84.20891,55430
357,lfacchinelli,6,0.01082,46683,84.21974,55430
358,misha-slyusarev,6,0.01082,46689,84.23056,55430
359,nepridumalnik,6,0.01082,46695,84.24139,55430
360,notchairmk,6,0.01082,46701,84.25221,55430
361,nsballmann,6,0.01082,46707,84.26303,55430
362,onbit-uchenik,6,0.01082,46713,84.27386,55430
363,panekj,6,0.01082,46719,84.28468,55430
364,piotrekkr,6,0.01082,46725,84.29551,55430
365,santiagon610,6,0.01082,46731,84.30633,55430
366,SaraSSC,6,0.01082,46737,84.31716,55430
367,sempervictus,6,0.01082,46743,84.32798,55430
368,ShadowScorpion,6,0.01082,46749,84.33881,55430
369,shira-lev,6,0.01082,46755,84.34963,55430
370,thulasirajkomminar,6,0.01082,46761,84.36045,55430
371,trentdibacco,6,0.01082,46767,84.37128,55430
372,Tristan971,6,0.01082,46773,84.38210,55430
373,ucfchandra,6,0.01082,46779,84.39293,55430
374,vamping111,6,0.01082,46785,84.40375,55430
375,vamshikrishna83,6,0.01082,46791,84.41458,55430
376,vknabel,6,0.01082,46797,84.42540,55430
377,wonko,6,0.01082,46803,84.43623,55430
378,zcxsythenew,6,0.01082,46809,84.44705,55430
379,AdamMir86,5,0.00902,46814,84.45607,55430
380,alexjurkiewicz,5,0.00902,46819,84.46509,55430
381,andrewluotechnologies,5,0.00902,46824,84.47411,55430
382,AnPucel,5,0.00902,46829,84.48313,55430
383,apottere,5,0.00902,46834,84.49215,55430
384,atsushi-ambo,5,0.00902,46839,84.50117,55430
385,averche,5,0.00902,46844,84.51019,55430
386,barrettclark,5,0.00902,46849,84.51921,55430
387,bgshacklett,5,0.00902,46854,84.52823,55430
388,bkielbasa,5,0.00902,46859,84.53725,55430
389,BondAnthony,5,0.00902,46864,84.54627,55430
390,braun1928,5,0.00902,46869,84.55529,55430
391,brittandeyoung,5,0.00902,46874,84.56432,55430
392,casevilus,5,0.00902,46879,84.57334,55430
393,chanstev,5,0.00902,46884,84.58236,55430
394,chouse-qumodity,5,0.00902,46889,84.59138,55430
395,closetofu,5,0.00902,46894,84.60040,55430
396,corpix,5,0.00902,46899,84.60942,55430
397,Cyb3r-Jak3,5,0.00902,46904,84.61844,55430
398,davidcodesido,5,0.00902,46909,84.62746,55430
399,daviewales,5,0.00902,46914,84.63648,55430
400,divStar,5,0.00902,46919,84.64550,55430
401,Doridian,5,0.00902,46924,84.65452,55430
402,eden881,5,0.00902,46929,84.66354,55430
403,egarbi,5,0.00902,46934,84.67256,55430
404,esprimo,5,0.00902,46939,84.68158,55430
405,ggiallo28,5,0.00902,46944,84.69060,55430
406,HubbardHarvey3,5,0.00902,46949,84.69962,55430
407,ikaygorodov,5,0.00902,46954,84.70864,55430
408,isometry,5,0.00902,46959,84.71766,55430
409,jakubabrzy,5,0.00902,46964,84.72668,55430
410,Janik-Haag,5,0.00902,46969,84.73570,55430
411,jan-mrm,5,0.00902,46974,84.74472,55430
412,jderieg,5,0.00902,46979,84.75374,55430
413,jebotz,5,0.00902,46984,84.76276,55430
414,jeroenhabets,5,0.00902,46989,84.77178,55430
415,jficz,5,0.00902,46994,84.78080,55430
416,Joelayo,5,0.00902,46999,84.78983,55430
417,jtyrus,5,0.00902,47004,84.79885,55430
418,kaffarell,5,0.00902,47009,84.80787,55430
419,kangasta,5,0.00902,47014,84.81689,55430
420,KelvinVenancio,5,0.00902,47019,84.82591,55430
421,krapgras,5,0.00902,47024,84.83493,55430
422,ksemele,5,0.00902,47029,84.84395,55430
423,leahrob,5,0.00902,47034,84.85297,55430
424,lens0021,5,0.00902,47039,84.86199,55430
425,malhussan,5,0.00902,47044,84.87101,55430
426,matteoredaelli,5,0.00902,47049,84.88003,55430
427,matthewbaggett,5,0.00902,47054,84.88905,55430
428,mermoldy,5,0.00902,47059,84.89807,55430
429,michaeltoohig,5,0.00902,47064,84.90709,55430
430,Modulariz,5,0.00902,47069,84.91611,55430
431,Moulick,5,0.00902,47074,84.92513,55430
432,NickElliot,5,0.00902,47079,84.93415,55430
433,openuuuser,5,0.00902,47084,84.94317,55430
434,paulomarquesc,5,0.00902,47089,84.95219,55430
435,ppuschmann,5,0.00902,47094,84.96121,55430
436,puni9869,5,0.00902,47099,84.97023,55430
437,rdctmeconomou,5,0.00902,47104,84.97925,55430
438,rizkybiz,5,0.00902,47109,84.98827,55430
439,RoozbehShafiee,5,0.00902,47114,84.99729,55430
440,sebhcp,5,0.00902,47119,85.00631,55430
441,SerhiiK,5,0.00902,47124,85.01533,55430
442,shahen94,5,0.00902,47129,85.02436,55430
443,squaresurf,5,0.00902,47134,85.03338,55430
444,sshiv5768,5,0.00902,47139,85.04240,55430
445,T0biii,5,0.00902,47144,85.05142,55430
446,tb3088,5,0.00902,47149,85.06044,55430
447,testwill,5,0.00902,47154,85.06946,55430
448,theipster,5,0.00902,47159,85.07848,55430
449,timurgen,5,0.00902,47164,85.08750,55430
450,triggan,5,0.00902,47169,85.09652,55430
451,vaerh,5,0.00902,47174,85.10554,55430
452,valyria257,5,0.00902,47179,85.11456,55430
453,xuoe,5,0.00902,47184,85.12358,55430
454,Yedfree,5,0.00902,47189,85.13260,55430
455,097115,4,0.00722,47193,85.13982,55430
456,adrianmester,4,0.00722,47197,85.14703,55430
457,afonso-pereira,4,0.00722,47201,85.15425,55430
458,AliSajid,4,0.00722,47205,85.16146,55430
459,alwindoss,4,0.00722,47209,85.16868,55430
460,AMitBehr,4,0.00722,47213,85.17590,55430
461,amkartashov,4,0.00722,47217,85.18311,55430
462,Apokalypt,4,0.00722,47221,85.19033,55430
463,AreenNser,4,0.00722,47225,85.19755,55430
464,AurimasNav,4,0.00722,47229,85.20476,55430
465,automatorz,4,0.00722,47233,85.21198,55430
466,autotune,4,0.00722,47237,85.21920,55430
467,awsaxeman,4,0.00722,47241,85.22641,55430
468,b4d-user,4,0.00722,47245,85.23363,55430
469,BlueIce,4,0.00722,47249,85.24084,55430
470,bnevis-i,4,0.00722,47253,85.24806,55430
471,boldandbusted,4,0.00722,47257,85.25528,55430
472,Botje,4,0.00722,47261,85.26249,55430
473,bufnitza,4,0.00722,47265,85.26971,55430
474,cgraf-spiria,4,0.00722,47269,85.27693,55430
475,coderwander,4,0.00722,47273,85.28414,55430
476,crdrost,4,0.00722,47277,85.29136,55430
477,crunchboy,4,0.00722,47281,85.29857,55430
478,DariuszPorowski,4,0.00722,47285,85.30579,55430
479,deepakbshetty,4,0.00722,47289,85.31301,55430
480,Deku-shrub,4,0.00722,47293,85.32022,55430
481,DerekCrosson,4,0.00722,47297,85.32744,55430
482,dmalch-hashicorp,4,0.00722,47301,85.33466,55430
483,Dok-dev,4,0.00722,47305,85.34187,55430
484,dragonfleas,4,0.00722,47309,85.34909,55430
485,dvasdekis,4,0.00722,47313,85.35631,55430
486,e12e,4,0.00722,47317,85.36352,55430
487,earlrob,4,0.00722,47321,85.37074,55430
488,elliott-weston-ki,4,0.00722,47325,85.37795,55430
489,esulzickis,4,0.00722,47329,85.38517,55430
490,Exchizz,4,0.00722,47333,85.39239,55430
491,fharper,4,0.00722,47337,85.39960,55430
492,gabops,4,0.00722,47341,85.40682,55430
493,gioleppe,4,0.00722,47345,85.41404,55430
494,graham-russell,4,0.00722,47349,85.42125,55430
495,hanneshofmann,4,0.00722,47353,85.42847,55430
496,hassannmoussaa,4,0.00722,47357,85.43568,55430
497,HenryGelderbloem,4,0.00722,47361,85.44290,55430
498,hiranimd,4,0.00722,47365,85.45012,55430
499,huix11,4,0.00722,47369,85.45733,55430
500,iambaim,4,0.00722,47373,85.46455,55430
501,igalklebanov,4,0.00722,47377,85.47177,55430
502,imdevin567,4,0.00722,47381,85.47898,55430
503,imperva-admin,4,0.00722,47385,85.48620,55430
504,itsjaspermilan,4,0.00722,47389,85.49342,55430
505,j4ng5y,4,0.00722,47393,85.50063,55430
506,jamesaorson,4,0.00722,47397,85.50785,55430
507,janet,4,0.00722,47401,85.51506,55430
508,jaydwit,4,0.00722,47405,85.52228,55430
509,jiaqchenO,4,0.00722,47409,85.52950,55430
510,jmservier,4,0.00722,47413,85.53671,55430
511,jooola,4,0.00722,47417,85.54393,55430
512,julienlevasseur,4,0.00722,47421,85.55115,55430
513,junktext,4,0.00722,47425,85.55836,55430
514,Kashemir001,4,0.00722,47429,85.56558,55430
515,keen99,4,0.00722,47433,85.57279,55430
516,keivinonline,4,0.00722,47437,85.58001,55430
517,kimdre,4,0.00722,47441,85.58723,55430
518,kszyma,4,0.00722,47445,85.59444,55430
519,LarsSven,4,0.00722,47449,85.60166,55430
520,Laudenlaruto,4,0.00722,47453,85.60888,55430
521,lhercot,4,0.00722,47457,85.61609,55430
522,liberodark,4,0.00722,47461,85.62331,55430
523,losisin,4,0.00722,47465,85.63052,55430
524,lsibilla,4,0.00722,47469,85.63774,55430
525,lunatik13,4,0.00722,47473,85.64496,55430
526,marciojv,4,0.00722,47477,85.65217,55430
527,markenzie,4,0.00722,47481,85.65939,55430
528,memes,4,0.00722,47485,85.66661,55430
529,mering,4,0.00722,47489,85.67382,55430
530,michiboo,4,0.00722,47493,85.68104,55430
531,mikemadeja,4,0.00722,47497,85.68826,55430
532,mirzaprangon,4,0.00722,47501,85.69547,55430
533,MPTG94,4,0.00722,47505,85.70269,55430
534,msamendinger,4,0.00722,47509,85.70990,55430
535,nckbnv,4,0.00722,47513,85.71712,55430
536,ned1313,4,0.00722,47517,85.72434,55430
537,NikolaLohinski,4,0.00722,47521,85.73155,55430
538,nikstuckenbrock,4,0.00722,47525,85.73877,55430
539,Nuru,4,0.00722,47529,85.74599,55430
540,patst,4,0.00722,47533,85.75320,55430
541,ppabis,4,0.00722,47537,85.76042,55430
542,RaitoBezarius,4,0.00722,47541,85.76763,55430
543,RaynorChavez,4,0.00722,47545,85.77485,55430
544,ricardbejarano,4,0.00722,47549,85.78207,55430
545,robbert229,4,0.00722,47553,85.78928,55430
546,RuslanShf,4,0.00722,47557,85.79650,55430
547,sagilaufer1992,4,0.00722,47561,85.80372,55430
548,sap147,4,0.00722,47565,85.81093,55430
549,sergioadorna,4,0.00722,47569,85.81815,55430
550,Siddarthyuvaraj,4,0.00722,47573,85.82537,55430
551,simoneb,4,0.00722,47577,85.83258,55430
552,sombrerosheep,4,0.00722,47581,85.83980,55430
553,StamenchoBog,4,0.00722,47585,85.84701,55430
554,stuartjbrown,4,0.00722,47589,85.85423,55430
555,surajsubramanian,4,0.00722,47593,85.86145,55430
556,tataranovich,4,0.00722,47597,85.86866,55430
557,terlar,4,0.00722,47601,85.87588,55430
558,thomasvjoseph,4,0.00722,47605,85.88310,55430
559,tiagogalvao,4,0.00722,47609,85.89031,55430
560,tropikhajma,4,0.00722,47613,85.89753,55430
561,trutled3,4,0.00722,47617,85.90474,55430
562,VanshSutariya,4,0.00722,47621,85.91196,55430
563,Venkoul99,4,0.00722,47625,85.91918,55430
564,vmilovanovicc,4,0.00722,47629,85.92639,55430
565,voidtek,4,0.00722,47633,85.93361,55430
566,werner-nops,4,0.00722,47637,85.94083,55430
567,WhiteApfel,4,0.00722,47641,85.94804,55430
568,xerra,4,0.00722,47645,85.95526,55430
569,zackpollard,4,0.00722,47649,85.96248,55430
570,ziggythehamster,4,0.00722,47653,85.96969,55430
571,ztzxt,4,0.00722,47657,85.97691,55430
572,ZzenlD,4,0.00722,47661,85.98412,55430
573,0x49f,3,0.00541,47664,85.98954,55430
574,223311,3,0.00541,47667,85.99495,55430
575,a83r,3,0.00541,47670,86.00036,55430
576,aclarknexient,3,0.00541,47673,86.00577,55430
577,adeepthinarayan,3,0.00541,47676,86.01119,55430
578,adrianofsantos,3,0.00541,47679,86.01660,55430
579,aksyuma,3,0.00541,47682,86.02201,55430
580,AlberErre,3,0.00541,47685,86.02742,55430
581,aldoborrero,3,0.00541,47688,86.03283,55430
582,alephpt,3,0.00541,47691,86.03825,55430
583,Alex-Caesar,3,0.00541,47694,86.04366,55430
584,AlexPykavy,3,0.00541,47697,86.04907,55430
585,alirezaghey,3,0.00541,47700,86.05448,55430
586,AndreasZeissner,3,0.00541,47703,86.05990,55430
587,antgel,3,0.00541,47706,86.06531,55430
588,AntonioKL,3,0.00541,47709,86.07072,55430
589,anuragvishwa,3,0.00541,47712,86.07613,55430
590,arpith-f5,3,0.00541,47715,86.08154,55430
591,arwalton,3,0.00541,47718,86.08696,55430
592,asbiin,3,0.00541,47721,86.09237,55430
593,asheshvidyut,3,0.00541,47724,86.09778,55430
594,athak,3,0.00541,47727,86.10319,55430
595,axza,3,0.00541,47730,86.10861,55430
596,ayashkov,3,0.00541,47733,86.11402,55430
597,b17k0,3,0.00541,47736,86.11943,55430
598,b4k3r,3,0.00541,47739,86.12484,55430
599,BarnabyShearer,3,0.00541,47742,86.13025,55430
600,bcantrill,3,0.00541,47745,86.13567,55430
601,be-aws-architect,3,0.00541,47748,86.14108,55430
602,BeElectronicSakshi,3,0.00541,47751,86.14649,55430
603,birjj,3,0.00541,47754,86.15190,55430
604,Breee,3,0.00541,47757,86.15732,55430
605,briancain,3,0.00541,47760,86.16273,55430
606,brkalow,3,0.00541,47763,86.16814,55430
607,captn3m0,3,0.00541,47766,86.17355,55430
608,Cein-Markey,3,0.00541,47769,86.17896,55430
609,chandra1-n,3,0.00541,47772,86.18438,55430
610,chrismarget-j,3,0.00541,47775,86.18979,55430
611,christiantosta,3,0.00541,47778,86.19520,55430
612,coderaycer,3,0.00541,47781,86.20061,55430
613,codergs,3,0.00541,47784,86.20603,55430
614,coderjoe,3,0.00541,47787,86.21144,55430
615,codexanonymous,3,0.00541,47790,86.21685,55430
616,codiini,3,0.00541,47793,86.22226,55430
617,codycodes,3,0.00541,47796,86.22767,55430
618,colinjlacy,3,0.00541,47799,86.23309,55430
619,crayfishx,3,0.00541,47802,86.23850,55430
620,crw,3,0.00541,47805,86.24391,55430
621,cybergavin,3,0.00541,47808,86.24932,55430
622,D3N2-A,3,0.00541,47811,86.25474,55430
623,dan-brodie,3,0.00541,47814,86.26015,55430
624,dansantf,3,0.00541,47817,86.26556,55430
625,dautovri,3,0.00541,47820,86.27097,55430
626,Daveyvdweide,3,0.00541,47823,86.27638,55430
627,dcantos1,3,0.00541,47826,86.28180,55430
628,delores-hashicorp,3,0.00541,47829,86.28721,55430
629,Dev79844,3,0.00541,47832,86.29262,55430
630,DharunKumar04,3,0.00541,47835,86.29803,55430
631,dherms,3,0.00541,47838,86.30345,55430
632,divyapola5,3,0.00541,47841,86.30886,55430
633,dizzyo,3,0.00541,47844,86.31427,55430
634,djryanj,3,0.00541,47847,86.31968,55430
635,dmchmk,3,0.00541,47850,86.32509,55430
636,dougforster-at,3,0.00541,47853,86.33051,55430
637,dropbigfish,3,0.00541,47856,86.33592,55430
638,dylan8902,3,0.00541,47859,86.34133,55430
639,emnedre,3,0.00541,47862,86.34674,55430
640,emocharnik,3,0.00541,47865,86.35216,55430
641,enmanuelmoreira,3,0.00541,47868,86.35757,55430
642,ers81239,3,0.00541,47871,86.36298,55430
643,eshutov,3,0.00541,47874,86.36839,55430
644,estebanz01,3,0.00541,47877,86.37380,55430
645,evanstucker-hates-2fa,3,0.00541,47880,86.37922,55430
646,fatbasstard,3,0.00541,47883,86.38463,55430
647,feliperezende-barbosa,3,0.00541,47886,86.39004,55430
648,ferreirafa,3,0.00541,47889,86.39545,55430
649,fluckx-cs,3,0.00541,47892,86.40087,55430
650,fuck-you-moron,3,0.00541,47895,86.40628,55430
651,FulecoRafa,3,0.00541,47898,86.41169,55430
652,GandalfUFR,3,0.00541,47901,86.41710,55430
653,gankidis,3,0.00541,47904,86.42251,55430
654,gavanlamb,3,0.00541,47907,86.42793,55430
655,gbw,3,0.00541,47910,86.43334,55430
656,gdubicki,3,0.00541,47913,86.43875,55430
657,gene-redpanda,3,0.00541,47916,86.44416,55430
658,grxnola,3,0.00541,47919,86.44958,55430
659,heldersepu,3,0.00541,47922,86.45499,55430
660,hlazrv,3,0.00541,47925,86.46040,55430
661,i4ki,3,0.00541,47928,86.46581,55430
662,iamsudip,3,0.00541,47931,86.47122,55430
663,ingcarlosperez,3,0.00541,47934,86.47664,55430
664,Insidexa,3,0.00541,47937,86.48205,55430
665,iwarapter,3,0.00541,47940,86.48746,55430
666,jandppw,3,0.00541,47943,86.49287,55430
667,javierruizjimenez,3,0.00541,47946,86.49829,55430
668,jbeemster,3,0.00541,47949,86.50370,55430
669,Jeerrryyyy,3,0.00541,47952,86.50911,55430
670,Jellayy,3,0.00541,47955,86.51452,55430
671,jessefarinacci,3,0.00541,47958,86.51994,55430
672,jhulndev,3,0.00541,47961,86.52535,55430
673,jntupal,3,0.00541,47964,86.53076,55430
674,joe-a-t,3,0.00541,47967,86.53617,55430
675,Joeri-Abbo,3,0.00541,47970,86.54158,55430
676,Jolcik,3,0.00541,47973,86.54700,55430
677,JonathanManass,3,0.00541,47976,86.55241,55430
678,Joshua-Beha,3,0.00541,47979,86.55782,55430
679,joshuamkite,3,0.00541,47982,86.56323,55430
680,jsfag,3,0.00541,47985,86.56865,55430
681,JustMarfix,3,0.00541,47988,86.57406,55430
682,juweins,3,0.00541,47991,86.57947,55430
683,KaiKorla,3,0.00541,47994,86.58488,55430
684,kamikazechaser,3,0.00541,47997,86.59029,55430
685,kirishikak98,3,0.00541,48000,86.59571,55430
686,kkang2097,3,0.00541,48003,86.60112,55430
687,kotvkvante,3,0.00541,48006,86.60653,55430
688,ksn135,3,0.00541,48009,86.61194,55430
689,ktham,3,0.00541,48012,86.61736,55430
690,kuredev,3,0.00541,48015,86.62277,55430
691,kuthiala,3,0.00541,48018,86.62818,55430
692,kylan11,3,0.00541,48021,86.63359,55430
693,Leandros,3,0.00541,48024,86.63900,55430
694,ledbutter,3,0.00541,48027,86.64442,55430
695,lpiot,3,0.00541,48030,86.64983,55430
696,lplazas,3,0.00541,48033,86.65524,55430
697,LucasBadico,3,0.00541,48036,86.66065,55430
698,lucasfcosta,3,0.00541,48039,86.66607,55430
699,LuisEGR,3,0.00541,48042,86.67148,55430
700,LukeCarrier,3,0.00541,48045,86.67689,55430
701,LumberjackUsingMath,3,0.00541,48048,86.68230,55430
702,mahadzaryab1,3,0.00541,48051,86.68771,55430
703,mahmod87,3,0.00541,48054,86.69313,55430
704,manish-hashicorp,3,0.00541,48057,86.69854,55430
705,matt-FFFFFF,3,0.00541,48060,86.70395,55430
706,matthewcummings,3,0.00541,48063,86.70936,55430
707,matthiasweaser,3,0.00541,48066,86.71478,55430
708,MaximilianoAguirre,3,0.00541,48069,86.72019,55430
709,mBlomsterberg,3,0.00541,48072,86.72560,55430
710,mex,3,0.00541,48075,86.73101,55430
711,mfurkanndemir,3,0.00541,48078,86.73642,55430
712,mhaggerty042,3,0.00541,48081,86.74184,55430
713,mishafeingold,3,0.00541,48084,86.74725,55430
714,Mjb141,3,0.00541,48087,86.75266,55430
715,mlhynfield,3,0.00541,48090,86.75807,55430
716,moabukar,3,0.00541,48093,86.76349,55430
717,mogol07,3,0.00541,48096,86.76890,55430
718,mpminardi,3,0.00541,48099,86.77431,55430
719,muandane,3,0.00541,48102,86.77972,55430
720,mulspace,3,0.00541,48105,86.78513,55430
721,mumoumit,3,0.00541,48108,86.79055,55430
722,mwos-sl,3,0.00541,48111,86.79596,55430
723,myc2h6o,3,0.00541,48114,86.80137,55430
724,nayang7,3,0.00541,48117,86.80678,55430
725,neilmartindev,3,0.00541,48120,86.81220,55430
726,nikhilsbhat,3,0.00541,48123,86.81761,55430
727,nikParasyr,3,0.00541,48126,86.82302,55430
728,nikuljain,3,0.00541,48129,86.82843,55430
729,nilgaar,3,0.00541,48132,86.83384,55430
730,nlantsuntsevich,3,0.00541,48135,86.83926,55430
731,Nmishin,3,0.00541,48138,86.84467,55430
732,nnstt1,3,0.00541,48141,86.85008,55430
733,offsetcyan,3,0.00541,48144,86.85549,55430
734,oifj34f34f,3,0.00541,48147,86.86091,55430
735,olexade,3,0.00541,48150,86.86632,55430
736,ovcharenko,3,0.00541,48153,86.87173,55430
737,owenfarrell,3,0.00541,48156,86.87714,55430
738,pandatix,3,0.00541,48159,86.88255,55430
739,Paul-Weaver,3,0.00541,48162,86.88797,55430
740,Perseus985,3,0.00541,48165,86.89338,55430
741,phoenix24,3,0.00541,48168,86.89879,55430
742,phoenixxbasit,3,0.00541,48171,86.90420,55430
743,PixarV,3,0.00541,48174,86.90962,55430
744,piyushsonigra,3,0.00541,48177,86.91503,55430
745,pjaudiomv,3,0.00541,48180,86.92044,55430
746,prashant3286,3,0.00541,48183,86.92585,55430
747,psantus,3,0.00541,48186,86.93126,55430
748,PScoriae,3,0.00541,48189,86.93668,55430
749,quantum-swiss,3,0.00541,48192,86.94209,55430
750,rcranganu,3,0.00541,48195,86.94750,55430
751,rdecatri,3,0.00541,48198,86.95291,55430
752,remiflament,3,0.00541,48201,86.95833,55430
753,Resonance1584,3,0.00541,48204,86.96374,55430
754,RFOTQ,3,0.00541,48207,86.96915,55430
755,rhysmcn,3,0.00541,48210,86.97456,55430
756,rosvik,3,0.00541,48213,86.97997,55430
757,rt1d6m7,3,0.00541,48216,86.98539,55430
758,rwc,3,0.00541,48219,86.99080,55430
759,saeedhosseini21,3,0.00541,48222,86.99621,55430
760,saidsef,3,0.00541,48225,87.00162,55430
761,sckn,3,0.00541,48228,87.00704,55430
762,Scorpil,3,0.00541,48231,87.01245,55430
763,ScottS-byte,3,0.00541,48234,87.01786,55430
764,Seraf,3,0.00541,48237,87.02327,55430
765,shblue21,3,0.00541,48240,87.02868,55430
766,shearn89,3,0.00541,48243,87.03410,55430
767,simonramosb,3,0.00541,48246,87.03951,55430
768,sirvantedbrl,3,0.00541,48249,87.04492,55430
769,skyscrapr,3,0.00541,48252,87.05033,55430
770,Solpio,3,0.00541,48255,87.05575,55430
771,spitzzz,3,0.00541,48258,87.06116,55430
772,stokedout,3,0.00541,48261,87.06657,55430
773,stoneus,3,0.00541,48264,87.07198,55430
774,stromp,3,0.00541,48267,87.07739,55430
775,sudoforge,3,0.00541,48270,87.08281,55430
776,suhailskhan,3,0.00541,48273,87.08822,55430
777,supertylerc,3,0.00541,48276,87.09363,55430
778,tannerjones4075,3,0.00541,48279,87.09904,55430
779,tarahmarie,3,0.00541,48282,87.10446,55430
780,teoliphant,3,0.00541,48285,87.10987,55430
781,TFCresset,3,0.00541,48288,87.11528,55430
782,themightymuppet,3,0.00541,48291,87.12069,55430
783,tiwood,3,0.00541,48294,87.12610,55430
784,tjhorner,3,0.00541,48297,87.13152,55430
785,tlinhh2,3,0.00541,48300,87.13693,55430
786,tmatilai,3,0.00541,48303,87.14234,55430
787,tomhunte,3,0.00541,48306,87.14775,55430
788,topperge,3,0.00541,48309,87.15317,55430
789,trend-lucas-wu,3,0.00541,48312,87.15858,55430
790,trevorbonas,3,0.00541,48315,87.16399,55430
791,troyanov,3,0.00541,48318,87.16940,55430
792,tthompson-figma,3,0.00541,48321,87.17482,55430
793,u900x600,3,0.00541,48324,87.18023,55430
794,v0nNemizez,3,0.00541,48327,87.18564,55430
795,vydra-cshub,3,0.00541,48330,87.19105,55430
796,webertrlz,3,0.00541,48333,87.19646,55430
797,wosiu,3,0.00541,48336,87.20188,55430
798,xabinapal,3,0.00541,48339,87.20729,55430
799,xiaxuantan,3,0.00541,48342,87.21270,55430
800,yan12125,3,0.00541,48345,87.21811,55430
801,yeoldegrove,3,0.00541,48348,87.22353,55430
802,zaaath,3,0.00541,48351,87.22894,55430
803,zisom-hc,3,0.00541,48354,87.23435,55430
804,0xThresh,2,0.00361,48356,87.23796,55430
805,416e64726579,2,0.00361,48358,87.24157,55430
806,4s3ti,2,0.00361,48360,87.24517,55430
807,aarontatar-upguard,2,0.00361,48362,87.24878,55430
808,abstrask,2,0.00361,48364,87.25239,55430
809,AdamElgressy,2,0.00361,48366,87.25600,55430
810,adityaparasar,2,0.00361,48368,87.25961,55430
811,aeiouaeiouaeiouaeiouaeiouaeiou,2,0.00361,48370,87.26321,55430
812,agelosnm,2,0.00361,48372,87.26682,55430
813,AHaymond,2,0.00361,48374,87.27043,55430
814,aichholzer,2,0.00361,48376,87.27404,55430
815,air3ijai,2,0.00361,48378,87.27765,55430
816,Akillon,2,0.00361,48380,87.28126,55430
817,albsilv-aws,2,0.00361,48382,87.28486,55430
818,AlekseiKulberg,2,0.00361,48384,87.28847,55430
819,alelb22,2,0.00361,48386,87.29208,55430
820,AlexTrinityBlock,2,0.00361,48388,87.29569,55430
821,alexwiese,2,0.00361,48390,87.29930,55430
822,AliAllomani,2,0.00361,48392,87.30290,55430
823,alselivonets,2,0.00361,48394,87.30651,55430
824,amir-khatibzadeh,2,0.00361,48396,87.31012,55430
825,AMMullan,2,0.00361,48398,87.31373,55430
826,Ananyasinha13,2,0.00361,48400,87.31734,55430
827,AndresMorelos,2,0.00361,48402,87.32095,55430
828,A-N-uraag,2,0.00361,48404,87.32455,55430
829,applejag,2,0.00361,48406,87.32816,55430
830,arnaud-dfns,2,0.00361,48408,87.33177,55430
831,arthurgustin,2,0.00361,48410,87.33538,55430
832,artificial-aidan,2,0.00361,48412,87.33899,55430
833,ashithwilson,2,0.00361,48414,87.34259,55430
834,asteriskie,2,0.00361,48416,87.34620,55430
835,atsaloli,2,0.00361,48418,87.34981,55430
836,avazula,2,0.00361,48420,87.35342,55430
837,away168,2,0.00361,48422,87.35703,55430
838,awsdannyc,2,0.00361,48424,87.36064,55430
839,BackInBash,2,0.00361,48426,87.36424,55430
840,baijuglad,2,0.00361,48428,87.36785,55430
841,baixinsui,2,0.00361,48430,87.37146,55430
842,bartvdbraak,2,0.00361,48432,87.37507,55430
843,bertekintw,2,0.00361,48434,87.37868,55430
844,Bhavyeshshah,2,0.00361,48436,87.38228,55430
845,bluszcz,2,0.00361,48438,87.38589,55430
846,bobthebuilderberlin,2,0.00361,48440,87.38950,55430
847,brahin2,2,0.00361,48442,87.39311,55430
848,brennoo,2,0.00361,48444,87.39672,55430
849,brinnjoyce,2,0.00361,48446,87.40032,55430
850,bruno,2,0.00361,48448,87.40393,55430
851,brunordias,2,0.00361,48450,87.40754,55430
852,bruvik,2,0.00361,48452,87.41115,55430
853,bt-macole,2,0.00361,48454,87.41476,55430
854,btrose1,2,0.00361,48456,87.41837,55430
855,caliban0,2,0.00361,48458,87.42197,55430
856,carocad,2,0.00361,48460,87.42558,55430
857,cchristous,2,0.00361,48462,87.42919,55430
858,ccrpc-fjunge,2,0.00361,48464,87.43280,55430
859,cdituri,2,0.00361,48466,87.43641,55430
860,cebecifaruk,2,0.00361,48468,87.44001,55430
861,cedricbraekevelt,2,0.00361,48470,87.44362,55430
862,cedricvanrompay-datadog,2,0.00361,48472,87.44723,55430
863,cesar-rodriguez,2,0.00361,48474,87.45084,55430
864,ChandlerSwift,2,0.00361,48476,87.45445,55430
865,chilledornaments,2,0.00361,48478,87.45806,55430
866,chriscunningham-cts,2,0.00361,48480,87.46166,55430
867,christian-hackl,2,0.00361,48482,87.46527,55430
868,clouddev0ps,2,0.00361,48484,87.46888,55430
869,coderkakarrot,2,0.00361,48486,87.47249,55430
870,CoPokBl,2,0.00361,48488,87.47610,55430
871,corewidedevops,2,0.00361,48490,87.47970,55430
872,coreywebber,2,0.00361,48492,87.48331,55430
873,cosmicvibes,2,0.00361,48494,87.48692,55430
874,cparedes,2,0.00361,48496,87.49053,55430
875,CRASH-Tech,2,0.00361,48498,87.49414,55430
876,Crond-Fx,2,0.00361,48500,87.49774,55430
877,CSymes,2,0.00361,48502,87.50135,55430
878,cybercyst,2,0.00361,48504,87.50496,55430
879,cybershoe,2,0.00361,48506,87.50857,55430
880,daegalus,2,0.00361,48508,87.51218,55430
881,DamianJarzebowski,2,0.00361,48510,87.51579,55430
882,damnedOperator,2,0.00361,48512,87.51939,55430
883,DanielRis,2,0.00361,48514,87.52300,55430
884,dannyibishev,2,0.00361,48516,87.52661,55430
885,dansiviter,2,0.00361,48518,87.53022,55430
886,Dansyuqri,2,0.00361,48520,87.53383,55430
887,darpakiss,2,0.00361,48522,87.53743,55430
888,dave-dotnet-overall,2,0.00361,48524,87.54104,55430
889,davelemons,2,0.00361,48526,87.54465,55430
890,davidgarvey,2,0.00361,48528,87.54826,55430
891,davidnortonjr,2,0.00361,48530,87.55187,55430
892,DavidTanner,2,0.00361,48532,87.55548,55430
893,david-yu,2,0.00361,48534,87.55908,55430
894,dbmurphy,2,0.00361,48536,87.56269,55430
895,DCCoder90,2,0.00361,48538,87.56630,55430
896,ddklein,2,0.00361,48540,87.56991,55430
897,debnamdev,2,0.00361,48542,87.57352,55430
898,delinea-sagar,2,0.00361,48544,87.57712,55430
899,Dennis1025-dev,2,0.00361,48546,87.58073,55430
900,DennisKreibichGKGAB,2,0.00361,48548,87.58434,55430
901,devlsc,2,0.00361,48550,87.58795,55430
902,dewhurstwill,2,0.00361,48552,87.59156,55430
903,dgr237,2,0.00361,48554,87.59517,55430
904,dhrkumar,2,0.00361,48556,87.59877,55430
905,dhs-rec,2,0.00361,48558,87.60238,55430
906,diamondzxd,2,0.00361,48560,87.60599,55430
907,digorgonzola,2,0.00361,48562,87.60960,55430
908,diogodias24,2,0.00361,48564,87.61321,55430
909,diraol,2,0.00361,48566,87.61681,55430
910,dmegbert,2,0.00361,48568,87.62042,55430
911,DmitryShonin,2,0.00361,48570,87.62403,55430
912,dmorozov82,2,0.00361,48572,87.62764,55430
913,dmurvihill,2,0.00361,48574,87.63125,55430
914,Doctor-love,2,0.00361,48576,87.63485,55430
915,domroutley,2,0.00361,48578,87.63846,55430
916,DonaldKellett,2,0.00361,48580,87.64207,55430
917,dotdc,2,0.00361,48582,87.64568,55430
918,Draed,2,0.00361,48584,87.64929,55430
919,dragetd,2,0.00361,48586,87.65290,55430
920,d-strobel,2,0.00361,48588,87.65650,55430
921,duedares-rvj,2,0.00361,48590,87.66011,55430
922,dwalintukan,2,0.00361,48592,87.66372,55430
923,eastebry,2,0.00361,48594,87.66733,55430
924,eddie-knight,2,0.00361,48596,87.67094,55430
925,edomaur,2,0.00361,48598,87.67454,55430
926,edscve,2,0.00361,48600,87.67815,55430
927,Egor3f,2,0.00361,48602,87.68176,55430
928,ehdis,2,0.00361,48604,87.68537,55430
929,EliaMaggioniSGS,2,0.00361,48606,87.68898,55430
930,elisiariocouto,2,0.00361,48608,87.69259,55430
931,EppO,2,0.00361,48610,87.69619,55430
932,ErikHumphrey,2,0.00361,48612,87.69980,55430
933,ErwinSalas,2,0.00361,48614,87.70341,55430
934,exequielrafaela,2,0.00361,48616,87.70702,55430
935,exoego,2,0.00361,48618,87.71063,55430
936,falanger,2,0.00361,48620,87.71423,55430
937,farhanangullia,2,0.00361,48622,87.71784,55430
938,fasibio,2,0.00361,48624,87.72145,55430
939,ferrucc-io,2,0.00361,48626,87.72506,55430
940,fitzgeraldsteele,2,0.00361,48628,87.72867,55430
941,flcdrg,2,0.00361,48630,87.73227,55430
942,flightlesstux,2,0.00361,48632,87.73588,55430
943,flobeier,2,0.00361,48634,87.73949,55430
944,flyte,2,0.00361,48636,87.74310,55430
945,fma965,2,0.00361,48638,87.74671,55430
946,franklouwers,2,0.00361,48640,87.75032,55430
947,galdor,2,0.00361,48642,87.75392,55430
948,ganievs,2,0.00361,48644,87.75753,55430
949,GAUTAMMANAK1,2,0.00361,48646,87.76114,55430
950,gedalyahreback,2,0.00361,48648,87.76475,55430
951,Gerthum,2,0.00361,48650,87.76836,55430
952,Ghostbird,2,0.00361,48652,87.77196,55430
953,Gokendra,2,0.00361,48654,87.77557,55430
954,gokendra1,2,0.00361,48656,87.77918,55430
955,goranvasic,2,0.00361,48658,87.78279,55430
956,gramsa49,2,0.00361,48660,87.78640,55430
957,green2jello,2,0.00361,48662,87.79001,55430
958,grulicht,2,0.00361,48664,87.79361,55430
959,gsedlacz,2,0.00361,48666,87.79722,55430
960,guspan-tanadi,2,0.00361,48668,87.80083,55430
961,gutocarvalho,2,0.00361,48670,87.80444,55430
962,gw0,2,0.00361,48672,87.80805,55430
963,gxben,2,0.00361,48674,87.81165,55430
964,HaanJde,2,0.00361,48676,87.81526,55430
965,Hadlock,2,0.00361,48678,87.81887,55430
966,haydentherapper,2,0.00361,48680,87.82248,55430
967,hedenface,2,0.00361,48682,87.82609,55430
968,helenfufu,2,0.00361,48684,87.82970,55430
969,hestio-serviceadmin,2,0.00361,48686,87.83330,55430
970,hghaf099,2,0.00361,48688,87.83691,55430
971,hginzel,2,0.00361,48690,87.84052,55430
972,hinricht,2,0.00361,48692,87.84413,55430
973,hong-yi,2,0.00361,48694,87.84774,55430
974,Hoseinjavadi283,2,0.00361,48696,87.85134,55430
975,iapicca,2,0.00361,48698,87.85495,55430
976,iloveicedgreentea,2,0.00361,48700,87.85856,55430
977,in0rdr,2,0.00361,48702,87.86217,55430
978,ineam,2,0.00361,48704,87.86578,55430
979,intari,2,0.00361,48706,87.86938,55430
980,Integralist,2,0.00361,48708,87.87299,55430
981,IS2511,2,0.00361,48710,87.87660,55430
982,Ivanuxus,2,0.00361,48712,87.88021,55430
983,iwahbe,2,0.00361,48714,87.88382,55430
984,Iwaslazkis,2,0.00361,48716,87.88743,55430
985,I-Would-Like-To-Report-A-Bug-Please,2,0.00361,48718,87.89103,55430
986,jackfarzan,2,0.00361,48720,87.89464,55430
987,JamesJJ,2,0.00361,48722,87.89825,55430
988,jamielinux,2,0.00361,48724,87.90186,55430
989,janfrederik,2,0.00361,48726,87.90547,55430
990,jaredfholgate,2,0.00361,48728,87.90907,55430
991,jcarloscandela,2,0.00361,48730,87.91268,55430
992,jchancellor-ms,2,0.00361,48732,87.91629,55430
993,Jebaseelanravi,2,0.00361,48734,87.91990,55430
994,Jeecie,2,0.00361,48736,87.92351,55430
995,JenGoldstrich,2,0.00361,48738,87.92712,55430
996,jgournet,2,0.00361,48740,87.93072,55430
997,jhirvioja,2,0.00361,48742,87.93433,55430
998,jimbocoder,2,0.00361,48744,87.93794,55430
999,jlarmstrong,2,0.00361,48746,87.94155,55430
1000,jmeisele,2,0.00361,48748,87.94516,55430
1001,jmlcv,2,0.00361,48750,87.94876,55430
1002,JoeMcNuggets,2,0.00361,48752,87.95237,55430
1003,johanntrigosnativapps,2,0.00361,48754,87.95598,55430
1004,johncf,2,0.00361,48756,87.95959,55430
1005,johnnorton,2,0.00361,48758,87.96320,55430
1006,jonas-l,2,0.00361,48760,87.96680,55430
1007,joneshf,2,0.00361,48762,87.97041,55430
1008,JonnyHaystack,2,0.00361,48764,87.97402,55430
1009,jonnyry,2,0.00361,48766,87.97763,55430
1010,Jpk518,2,0.00361,48768,87.98124,55430
1011,jplitza,2,0.00361,48770,87.98485,55430
1012,jrmash,2,0.00361,48772,87.98845,55430
1013,jtdoepke,2,0.00361,48774,87.99206,55430
1014,jtexeira,2,0.00361,48776,87.99567,55430
1015,juancarlosjr97,2,0.00361,48778,87.99928,55430
1016,jumpersk,2,0.00361,48780,88.00289,55430
1017,juranir,2,0.00361,48782,88.00649,55430
1018,KacperMalachowski,2,0.00361,48784,88.01010,55430
1019,k-bertrand,2,0.00361,48786,88.01371,55430
1020,keeefer,2,0.00361,48788,88.01732,55430
1021,kevineor,2,0.00361,48790,88.02093,55430
1022,kfcampbell,2,0.00361,48792,88.02454,55430
1023,Khaz66,2,0.00361,48794,88.02814,55430
1024,KiaraGrouwstra,2,0.00361,48796,88.03175,55430
1025,kibblator,2,0.00361,48798,88.03536,55430
1026,KiPIDesTAN,2,0.00361,48800,88.03897,55430
1027,kkitai,2,0.00361,48802,88.04258,55430
1028,klolik,2,0.00361,48804,88.04618,55430
1029,kolegych,2,0.00361,48806,88.04979,55430
1030,kolesaev,2,0.00361,48808,88.05340,55430
1031,Kosmas,2,0.00361,48810,88.05701,55430
1032,kotkoroid,2,0.00361,48812,88.06062,55430
1033,KyMidd,2,0.00361,48814,88.06423,55430
1034,L1ghtman2k,2,0.00361,48816,88.06783,55430
1035,lanrongwen,2,0.00361,48818,88.07144,55430
1036,Lawliet2012,2,0.00361,48820,88.07505,55430
1037,LearningNewbie,2,0.00361,48822,88.07866,55430
1038,lenaing,2,0.00361,48824,88.08227,55430
1039,leo2m,2,0.00361,48826,88.08587,55430
1040,lesaux,2,0.00361,48828,88.08948,55430
1041,liath,2,0.00361,48830,88.09309,55430
1042,lijok,2,0.00361,48832,88.09670,55430
1043,litelitelite,2,0.00361,48834,88.10031,55430
1044,luciusf,2,0.00361,48836,88.10391,55430
1045,Lu-Ka,2,0.00361,48838,88.10752,55430
1046,lyokomoko,2,0.00361,48840,88.11113,55430
1047,Madhu-mohan86,2,0.00361,48842,88.11474,55430
1048,Madko,2,0.00361,48844,88.11835,55430
1049,mageshwaransekar,2,0.00361,48846,88.12196,55430
1050,mahesh00009,2,0.00361,48848,88.12556,55430
1051,maikelpoot,2,0.00361,48850,88.12917,55430
1052,majormoses,2,0.00361,48852,88.13278,55430
1053,maordavidov,2,0.00361,48854,88.13639,55430
1054,marceloalmeida,2,0.00361,48856,88.14000,55430
1055,marcindulak,2,0.00361,48858,88.14360,55430
1056,martinhaus,2,0.00361,48860,88.14721,55430
1057,matheus-dr,2,0.00361,48862,88.15082,55430
1058,matthewaerose,2,0.00361,48864,88.15443,55430
1059,mattwilder,2,0.00361,48866,88.15804,55430
1060,maZahaca,2,0.00361,48868,88.16165,55430
1061,mbianchidev,2,0.00361,48870,88.16525,55430
1062,mbklein,2,0.00361,48872,88.16886,55430
1063,mcalhoun,2,0.00361,48874,88.17247,55430
1064,metaloid2k21,2,0.00361,48876,88.17608,55430
1065,mgyucht,2,0.00361,48878,88.17969,55430
1066,mi4i0,2,0.00361,48880,88.18329,55430
1067,MichaelChristopherson,2,0.00361,48882,88.18690,55430
1068,michvllni,2,0.00361,48884,88.19051,55430
1069,miend,2,0.00361,48886,88.19412,55430
1070,mieseprem,2,0.00361,48888,88.19773,55430
1071,mik3h0,2,0.00361,48890,88.20134,55430
1072,MikhailAseev,2,0.00361,48892,88.20494,55430
1073,milkshakeuk,2,0.00361,48894,88.20855,55430
1074,MNThomson,2,0.00361,48896,88.21216,55430
1075,mo3789530,2,0.00361,48898,88.21577,55430
1076,Morzan6,2,0.00361,48900,88.21938,55430
1077,moss2k13,2,0.00361,48902,88.22298,55430
1078,mtesch-um,2,0.00361,48904,88.22659,55430
1079,mtt88,2,0.00361,48906,88.23020,55430
1080,muffl0n,2,0.00361,48908,88.23381,55430
1081,myerscf,2,0.00361,48910,88.23742,55430
1082,N0zz,2,0.00361,48912,88.24102,55430
1083,nec-r-kubota,2,0.00361,48914,88.24463,55430
1084,nellyk,2,0.00361,48916,88.24824,55430
1085,ngortheone,2,0.00361,48918,88.25185,55430
1086,Nils-Magnus,2,0.00361,48920,88.25546,55430
1087,ning-kang,2,0.00361,48922,88.25907,55430
1088,nint8835,2,0.00361,48924,88.26267,55430
1089,NishkarshRaj,2,0.00361,48926,88.26628,55430
1090,nithishravindra,2,0.00361,48928,88.26989,55430
1091,nolotz,2,0.00361,48930,88.27350,55430
1092,not-igalze,2,0.00361,48932,88.27711,55430
1093,nthienan,2,0.00361,48934,88.28071,55430
1094,nwmcsween,2,0.00361,48936,88.28432,55430
1095,nwmqpa,2,0.00361,48938,88.28793,55430
1096,OleksandrUA,2,0.00361,48940,88.29154,55430
1097,OLeonardoRodrigues,2,0.00361,48942,88.29515,55430
1098,oltur,2,0.00361,48944,88.29876,55430
1099,ondrejsika,2,0.00361,48946,88.30236,55430
1100,OpenGLShaders,2,0.00361,48948,88.30597,55430
1101,Orexii,2,0.00361,48950,88.30958,55430
1102,o-sama,2,0.00361,48952,88.31319,55430
1103,oscarhermoso,2,0.00361,48954,88.31680,55430
1104,otcbot,2,0.00361,48956,88.32040,55430
1105,outscale-rce,2,0.00361,48958,88.32401,55430
1106,outscale-toa,2,0.00361,48960,88.32762,55430
1107,Ozzard,2,0.00361,48962,88.33123,55430
1108,pacaroha,2,0.00361,48964,88.33484,55430
1109,papegaaij,2,0.00361,48966,88.33844,55430
1110,Parziwal,2,0.00361,48968,88.34205,55430
1111,PatBolkun,2,0.00361,48970,88.34566,55430
1112,paulschwarzenberger,2,0.00361,48972,88.34927,55430
1113,pawelaugustyn,2,0.00361,48974,88.35288,55430
1114,pdefreitas,2,0.00361,48976,88.35649,55430
1115,peletv2,2,0.00361,48978,88.36009,55430
1116,PePoDev,2,0.00361,48980,88.36370,55430
1117,peterwwillis,2,0.00361,48982,88.36731,55430
1118,pgdad,2,0.00361,48984,88.37092,55430
1119,pikachuSparkle,2,0.00361,48986,88.37453,55430
1120,Pospelove,2,0.00361,48988,88.37813,55430
1121,povisenko,2,0.00361,48990,88.38174,55430
1122,PranavVerma-droid,2,0.00361,48992,88.38535,55430
1123,Progern,2,0.00361,48994,88.38896,55430
1124,qcxrvb,2,0.00361,48996,88.39257,55430
1125,quantumsheep,2,0.00361,48998,88.39618,55430
1126,rafaelgieschke,2,0.00361,49000,88.39978,55430
1127,ralzareck,2,0.00361,49002,88.40339,55430
1128,ramonsnir,2,0.00361,49004,88.40700,55430
1129,ranser102,2,0.00361,49006,88.41061,55430
1130,rawtaz,2,0.00361,49008,88.41422,55430
1131,rishabhToshniwal,2,0.00361,49010,88.41782,55430
1132,rjudin,2,0.00361,49012,88.42143,55430
1133,rkarpuzov,2,0.00361,49014,88.42504,55430
1134,rmartine-ias,2,0.00361,49016,88.42865,55430
1135,rmt,2,0.00361,49018,88.43226,55430
1136,rndph,2,0.00361,49020,88.43587,55430
1137,rnemeth90,2,0.00361,49022,88.43947,55430
1138,roliverio,2,0.00361,49024,88.44308,55430
1139,rossifumax,2,0.00361,49026,88.44669,55430
1140,rromic,2,0.00361,49028,88.45030,55430
1141,rschmied,2,0.00361,49030,88.45391,55430
1142,rswrz,2,0.00361,49032,88.45751,55430
1143,rulev,2,0.00361,49034,88.46112,55430
1144,rvbuelow,2,0.00361,49036,88.46473,55430
1145,rwkymapcreator,2,0.00361,49038,88.46834,55430
1146,RyanDerr,2,0.00361,49040,88.47195,55430
1147,ryepup,2,0.00361,49042,88.47555,55430
1148,s4heid,2,0.00361,49044,88.47916,55430
1149,SamuelMarks,2,0.00361,49046,88.48277,55430
1150,samuelrcarvalho,2,0.00361,49048,88.48638,55430
1151,samvelie,2,0.00361,49050,88.48999,55430
1152,sanket28,2,0.00361,49052,88.49360,55430
1153,satishweb,2,0.00361,49054,88.49720,55430
1154,sberdashkevich,2,0.00361,49056,88.50081,55430
1155,SchwabJust1n,2,0.00361,49058,88.50442,55430
1156,scott-doyland-burrows,2,0.00361,49060,88.50803,55430
1157,sdwvit,2,0.00361,49062,88.51164,55430
1158,seasadm,2,0.00361,49064,88.51524,55430
1159,serber,2,0.00361,49066,88.51885,55430
1160,sergeybe2,2,0.00361,49068,88.52246,55430
1161,serialseb,2,0.00361,49070,88.52607,55430
1162,shabeebk,2,0.00361,49072,88.52968,55430
1163,ShanArosh,2,0.00361,49074,88.53329,55430
1164,ShimonOhayon,2,0.00361,49076,88.53689,55430
1165,shmunorbury,2,0.00361,49078,88.54050,55430
1166,shoeffner,2,0.00361,49080,88.54411,55430
1167,shubhindia,2,0.00361,49082,88.54772,55430
1168,siddharthasonker,2,0.00361,49084,88.55133,55430
1169,sikha-root,2,0.00361,49086,88.55493,55430
1170,sinuscosinustan,2,0.00361,49088,88.55854,55430
1171,skycarl,2,0.00361,49090,88.56215,55430
1172,slabstone,2,0.00361,49092,88.56576,55430
1173,slackfan,2,0.00361,49094,88.56937,55430
1174,slaughtr,2,0.00361,49096,88.57297,55430
1175,slopez93,2,0.00361,49098,88.57658,55430
1176,sms-astanley,2,0.00361,49100,88.58019,55430
1177,sonbui00,2,0.00361,49102,88.58380,55430
1178,sosimon,2,0.00361,49104,88.58741,55430
1179,specialtactics,2,0.00361,49106,88.59102,55430
1180,speller,2,0.00361,49108,88.59462,55430
1181,spham,2,0.00361,49110,88.59823,55430
1182,sportlane,2,0.00361,49112,88.60184,55430
1183,srevinsaju,2,0.00361,49114,88.60545,55430
1184,srinivasrafay,2,0.00361,49116,88.60906,55430
1185,ssakuh,2,0.00361,49118,88.61266,55430
1186,sschu,2,0.00361,49120,88.61627,55430
1187,ssharmasandeep,2,0.00361,49122,88.61988,55430
1188,stacksegv,2,0.00361,49124,88.62349,55430
1189,staizen-stephen,2,0.00361,49126,88.62710,55430
1190,stuart-mclaren-hpe,2,0.00361,49128,88.63071,55430
1191,svanzoest,2,0.00361,49130,88.63431,55430
1192,Sysa,2,0.00361,49132,88.63792,55430
1193,Szasza,2,0.00361,49134,88.64153,55430
1194,t0yv0,2,0.00361,49136,88.64514,55430
1195,TeaAlc,2,0.00361,49138,88.64875,55430
1196,tedsmitt,2,0.00361,49140,88.65235,55430
1197,TheisFerre,2,0.00361,49142,88.65596,55430
1198,theonlyames,2,0.00361,49144,88.65957,55430
1199,thiagofanfoni,2,0.00361,49146,88.66318,55430
1200,thiago-scherrer,2,0.00361,49148,88.66679,55430
1201,ThomasLachaux,2,0.00361,49150,88.67040,55430
1202,tigpt,2,0.00361,49152,88.67400,55430
1203,TJNII,2,0.00361,49154,88.67761,55430
1204,TomKondat,2,0.00361,49156,88.68122,55430
1205,tongueroo,2,0.00361,49158,88.68483,55430
1206,TonyLovesDevOps,2,0.00361,49160,88.68844,55430
1207,trc-rkorneev,2,0.00361,49162,88.69204,55430
1208,tusharpandit18,2,0.00361,49164,88.69565,55430
1209,ty-v1,2,0.00361,49166,88.69926,55430
1210,tzabbi,2,0.00361,49168,88.70287,55430
1211,Valatka,2,0.00361,49170,88.70648,55430
1212,vanzhiganov,2,0.00361,49172,88.71008,55430
1213,vbouchaud,2,0.00361,49174,88.71369,55430
1214,vessellook,2,0.00361,49176,88.71730,55430
1215,vhlukhov,2,0.00361,49178,88.72091,55430
1216,VinitTomar,2,0.00361,49180,88.72452,55430
1217,vipinvkmenon,2,0.00361,49182,88.72813,55430
1218,VirtualZer0,2,0.00361,49184,88.73173,55430
1219,vmvarela,2,0.00361,49186,88.73534,55430
1220,vtstanescu,2,0.00361,49188,88.73895,55430
1221,walkline,2,0.00361,49190,88.74256,55430
1222,wcarlsen,2,0.00361,49192,88.74617,55430
1223,WestonReed,2,0.00361,49194,88.74977,55430
1224,What-is-water93,2,0.00361,49196,88.75338,55430
1225,WhyNotHugo,2,0.00361,49198,88.75699,55430
1226,wombelix,2,0.00361,49200,88.76060,55430
1227,wrzolekLukasz,2,0.00361,49202,88.76421,55430
1228,WSpacelifT,2,0.00361,49204,88.76782,55430
1229,wzq2023,2,0.00361,49206,88.77142,55430
1230,xescab,2,0.00361,49208,88.77503,55430
1231,xoronet,2,0.00361,49210,88.77864,55430
1232,yaa110,2,0.00361,49212,88.78225,55430
1233,yogeshlc,2,0.00361,49214,88.78586,55430
1234,Z4ck404,2,0.00361,49216,88.78946,55430
1235,zach-withcoherence,2,0.00361,49218,88.79307,55430
1236,zanate4019,2,0.00361,49220,88.79668,55430
1237,ZaneHero,2,0.00361,49222,88.80029,55430
1238,zartdinov,2,0.00361,49224,88.80390,55430
1239,zengzzzzz,2,0.00361,49226,88.80750,55430
1240,zliang-akamai,2,0.00361,49228,88.81111,55430
1241,ZPascal,2,0.00361,49230,88.81472,55430
1242,zwindler,2,0.00361,49232,88.81833,55430
1243,0mnius,1,0.00180,49233,88.82013,55430
1244,0x91,1,0.00180,49234,88.82194,55430
1245,0xCiBeR,1,0.00180,49235,88.82374,55430
1246,0xF6,1,0.00180,49236,88.82555,55430
1247,16g,1,0.00180,49237,88.82735,55430
1248,3579km,1,0.00180,49238,88.82915,55430
1249,98rahul,1,0.00180,49239,88.83096,55430
1250,a10pepo,1,0.00180,49240,88.83276,55430
1251,aaadr1an,1,0.00180,49241,88.83457,55430
1252,aaajhs,1,0.00180,49242,88.83637,55430
1253,aaarichter,1,0.00180,49243,88.83817,55430
1254,aalekhpatel07,1,0.00180,49244,88.83998,55430
1255,aaronearles,1,0.00180,49245,88.84178,55430
1256,aaron-lewis-insight,1,0.00180,49246,88.84359,55430
1257,abacao,1,0.00180,49247,88.84539,55430
1258,abakanovskii,1,0.00180,49248,88.84719,55430
1259,abashev,1,0.00180,49249,88.84900,55430
1260,abdo-farag,1,0.00180,49250,88.85080,55430
1261,abelnieva,1,0.00180,49251,88.85261,55430
1262,abestel,1,0.00180,49252,88.85441,55430
1263,abhayporwals,1,0.00180,49253,88.85622,55430
1264,abhishek-hashicorp,1,0.00180,49254,88.85802,55430
1265,ablackrw,1,0.00180,49255,88.85982,55430
1266,AButler,1,0.00180,49256,88.86163,55430
1267,access-domroutley,1,0.00180,49257,88.86343,55430
1268,acch,1,0.00180,49258,88.86524,55430
1269,acehand,1,0.00180,49259,88.86704,55430
1270,a-Chai,1,0.00180,49260,88.86884,55430
1271,achernev,1,0.00180,49261,88.87065,55430
1272,Adam-Gold,1,0.00180,49262,88.87245,55430
1273,AdamRussak,1,0.00180,49263,88.87426,55430
1274,ADeakinELS,1,0.00180,49264,88.87606,55430
1275,adelinn,1,0.00180,49265,88.87786,55430
1276,adityaraval,1,0.00180,49266,88.87967,55430
1277,adjokic,1,0.00180,49267,88.88147,55430
1278,adrenalineBot,1,0.00180,49268,88.88328,55430
1279,adrianfuro,1,0.00180,49269,88.88508,55430
1280,adrianjarc,1,0.00180,49270,88.88688,55430
1281,adriansuarez,1,0.00180,49271,88.88869,55430
1282,adyavanapalli,1,0.00180,49272,88.89049,55430
1283,AetherUnbound,1,0.00180,49273,88.89230,55430
1284,africanzoe,1,0.00180,49274,88.89410,55430
1285,agazeley,1,0.00180,49275,88.89590,55430
1286,agger-magenta,1,0.00180,49276,88.89771,55430
1287,agreaves-ms,1,0.00180,49277,88.89951,55430
1288,agu3rra,1,0.00180,49278,88.90132,55430
1289,AgustinBettati,1,0.00180,49279,88.90312,55430
1290,ahamez,1,0.00180,49280,88.90493,55430
1291,aharont,1,0.00180,49281,88.90673,55430
1292,aharontwizer,1,0.00180,49282,88.90853,55430
1293,aherbst-broad,1,0.00180,49283,88.91034,55430
1294,ahmadank,1,0.00180,49284,88.91214,55430
1295,AhmedQaziMuhammadJamil,1,0.00180,49285,88.91395,55430
1296,aiiamnot,1,0.00180,49286,88.91575,55430
1297,AislingHPE,1,0.00180,49287,88.91755,55430
1298,ajaffie,1,0.00180,49288,88.91936,55430
1299,ajax-ryzhyi-r,1,0.00180,49289,88.92116,55430
1300,ajinkya101,1,0.00180,49290,88.92297,55430
1301,AJS23,1,0.00180,49291,88.92477,55430
1302,akhateeb22,1,0.00180,49292,88.92657,55430
1303,akhilk2802,1,0.00180,49293,88.92838,55430
1304,akisakye,1,0.00180,49294,88.93018,55430
1305,akshar-rafay,1,0.00180,49295,88.93199,55430
1306,Akshat0694,1,0.00180,49296,88.93379,55430
1307,akshay2000,1,0.00180,49297,88.93559,55430
1308,AlanJumeaucourt,1,0.00180,49298,88.93740,55430
1309,albertodonato,1,0.00180,49299,88.93920,55430
1310,albgus,1,0.00180,49300,88.94101,55430
1311,alecmev,1,0.00180,49301,88.94281,55430
1312,aleksandar-babic,1,0.00180,49302,88.94461,55430
1313,aleksandarknezevic,1,0.00180,49303,88.94642,55430
1314,aleksey-perplexity,1,0.00180,49304,88.94822,55430
1315,aleprice,1,0.00180,49305,88.95003,55430
1316,alexanderruch,1,0.00180,49306,88.95183,55430
1317,AlexanderWiechert,1,0.00180,49307,88.95364,55430
1318,alexandrospanayi,1,0.00180,49308,88.95544,55430
1319,AlexAtkinson,1,0.00180,49309,88.95724,55430
1320,AlexAtSea,1,0.00180,49310,88.95905,55430
1321,Alex-HuXD,1,0.00180,49311,88.96085,55430
1322,alexjfisher,1,0.00180,49312,88.96266,55430
1323,alex-px,1,0.00180,49313,88.96446,55430
1324,Alex-Waring,1,0.00180,49314,88.96626,55430
1325,allevimi,1,0.00180,49315,88.96807,55430
1326,allxiaa,1,0.00180,49316,88.96987,55430
1327,AlphaLink4,1,0.00180,49317,88.97168,55430
1328,alvarosaavedrau,1,0.00180,49318,88.97348,55430
1329,Amal-J,1,0.00180,49319,88.97528,55430
1330,amardatar,1,0.00180,49320,88.97709,55430
1331,amartin-isp,1,0.00180,49321,88.97889,55430
1332,amcsi,1,0.00180,49322,88.98070,55430
1333,ameeno,1,0.00180,49323,88.98250,55430
1334,amhashicorp,1,0.00180,49324,88.98430,55430
1335,amirkkn,1,0.00180,49325,88.98611,55430
1336,amtryingmybest,1,0.00180,49326,88.98791,55430
1337,ancoron,1,0.00180,49327,88.98972,55430
1338,andaryjo,1,0.00180,49328,88.99152,55430
1339,anden-akkio,1,0.00180,49329,88.99332,55430
1340,andreashaerter,1,0.00180,49330,88.99513,55430
1341,andreaswwilson,1,0.00180,49331,88.99693,55430
1342,andrebossi,1,0.00180,49332,88.99874,55430
1343,AndrewKolegov,1,0.00180,49333,89.00054,55430
1344,andrewmelis,1,0.00180,49334,89.00235,55430
1345,andrey-kuznetsov,1,0.00180,49335,89.00415,55430
1346,AndreyPilipenko,1,0.00180,49336,89.00595,55430
1347,andyleap,1,0.00180,49337,89.00776,55430
1348,aneillans,1,0.00180,49338,89.00956,55430
1349,angelstan,1,0.00180,49339,89.01137,55430
1350,AnitaErnszt,1,0.00180,49340,89.01317,55430
1351,a-nldisr,1,0.00180,49341,89.01497,55430
1352,anmoel,1,0.00180,49342,89.01678,55430
1353,anmolnagpal,1,0.00180,49343,89.01858,55430
1354,anshulsao,1,0.00180,49344,89.02039,55430
1355,ansraliant,1,0.00180,49345,89.02219,55430
1356,anthonyangel,1,0.00180,49346,89.02399,55430
1357,antmordel,1,0.00180,49347,89.02580,55430
1358,anxkha,1,0.00180,49348,89.02760,55430
1359,aofodo,1,0.00180,49349,89.02941,55430
1360,aorozco-g,1,0.00180,49350,89.03121,55430
1361,a-osipov-pixonic,1,0.00180,49351,89.03301,55430
1362,Applicafroguy,1,0.00180,49352,89.03482,55430
1363,arax,1,0.00180,49353,89.03662,55430
1364,architec,1,0.00180,49354,89.03843,55430
1365,archoversight,1,0.00180,49355,89.04023,55430
1366,ArcoKim,1,0.00180,49356,89.04203,55430
1367,aredshift,1,0.00180,49357,89.04384,55430
1368,areis422,1,0.00180,49358,89.04564,55430
1369,Areso,1,0.00180,49359,89.04745,55430
1370,argo1984,1,0.00180,49360,89.04925,55430
1371,ariel-weiss,1,0.00180,49361,89.05106,55430
1372,arikg10,1,0.00180,49362,89.05286,55430
1373,arminfelder,1,0.00180,49363,89.05466,55430
1374,aron-ac,1,0.00180,49364,89.05647,55430
1375,arsenicks,1,0.00180,49365,89.05827,55430
1376,arterro,1,0.00180,49366,89.06008,55430
1377,arthurkamwt10,1,0.00180,49367,89.06188,55430
1378,artsiom-aliakseichyk,1,0.00180,49368,89.06368,55430
1379,a-rustacean,1,0.00180,49369,89.06549,55430
1380,arylatt,1,0.00180,49370,89.06729,55430
1381,aryounce,1,0.00180,49371,89.06910,55430
1382,asbarbati,1,0.00180,49372,89.07090,55430
1383,asbjorn-wiik,1,0.00180,49373,89.07270,55430
1384,asensionacher,1,0.00180,49374,89.07451,55430
1385,ashenm,1,0.00180,49375,89.07631,55430
1386,A-Shevchenko,1,0.00180,49376,89.07812,55430
1387,ashtonian,1,0.00180,49377,89.07992,55430
1388,ashulaev,1,0.00180,49378,89.08172,55430
1389,ashwin2125,1,0.00180,49379,89.08353,55430
1390,ashwinuday,1,0.00180,49380,89.08533,55430
1391,AshXD007,1,0.00180,49381,89.08714,55430
1392,aslamovamir,1,0.00180,49382,89.08894,55430
1393,aslatter,1,0.00180,49383,89.09075,55430
1394,asos-chrisnorman,1,0.00180,49384,89.09255,55430
1395,assiakhateeb,1,0.00180,49385,89.09435,55430
1396,astorrs,1,0.00180,49386,89.09616,55430
1397,astrozyk,1,0.00180,49387,89.09796,55430
1398,asutoshjena1,1,0.00180,49388,89.09977,55430
1399,a-takamin,1,0.00180,49389,89.10157,55430
1400,atheken,1,0.00180,49390,89.10337,55430
1401,atkretsch,1,0.00180,49391,89.10518,55430
1402,atobaum,1,0.00180,49392,89.10698,55430
1403,ATREAY,1,0.00180,49393,89.10879,55430
1404,atreyamohan,1,0.00180,49394,89.11059,55430
1405,attachmentgenie,1,0.00180,49395,89.11239,55430
1406,AuracleTech,1,0.00180,49396,89.11420,55430
1407,austrowGC,1,0.00180,49397,89.11600,55430
1408,aveiga,1,0.00180,49398,89.11781,55430
1409,avijeetsm,1,0.00180,49399,89.11961,55430
1410,Avlasov18,1,0.00180,49400,89.12141,55430
1411,avnerenv0,1,0.00180,49401,89.12322,55430
1412,avnes,1,0.00180,49402,89.12502,55430
1413,awgibbs,1,0.00180,49403,89.12683,55430
1414,Axel519,1,0.00180,49404,89.12863,55430
1415,axzu112,1,0.00180,49405,89.13043,55430
1416,AymenSegni,1,0.00180,49406,89.13224,55430
1417,ayodelespencer,1,0.00180,49407,89.13404,55430
1418,ayofimihan,1,0.00180,49408,89.13585,55430
1419,ayumitamai97,1,0.00180,49409,89.13765,55430
1420,azanafredi,1,0.00180,49410,89.13946,55430
1421,azuwis,1,0.00180,49411,89.14126,55430
1422,B1Z0N,1,0.00180,49412,89.14306,55430
1423,baaym,1,0.00180,49413,89.14487,55430
1424,babico,1,0.00180,49414,89.14667,55430
1425,ballesterosd,1,0.00180,49415,89.14848,55430
1426,bannarisoftwares,1,0.00180,49416,89.15028,55430
1427,barboteur,1,0.00180,49417,89.15208,55430
1428,baterja,1,0.00180,49418,89.15389,55430
1429,batonogov,1,0.00180,49419,89.15569,55430
1430,bayram-dev,1,0.00180,49420,89.15750,55430
1431,bbaabemhp,1,0.00180,49421,89.15930,55430
1432,bberg-indeed,1,0.00180,49422,89.16110,55430
1433,bcsamrudh,1,0.00180,49423,89.16291,55430
1434,bdpennington,1,0.00180,49424,89.16471,55430
1435,bealesh,1,0.00180,49425,89.16652,55430
1436,beji,1,0.00180,49426,89.16832,55430
1437,BenHall-1,1,0.00180,49427,89.17012,55430
1438,benignbala,1,0.00180,49428,89.17193,55430
1439,benjacksondev,1,0.00180,49429,89.17373,55430
1440,benjamb,1,0.00180,49430,89.17554,55430
1441,benjamin-wright,1,0.00180,49431,89.17734,55430
1442,benjipeng,1,0.00180,49432,89.17914,55430
1443,benkoben,1,0.00180,49433,89.18095,55430
1444,benniemosher,1,0.00180,49434,89.18275,55430
1445,berahac,1,0.00180,49435,89.18456,55430
1446,berahtlv,1,0.00180,49436,89.18636,55430
1447,BergCyrill,1,0.00180,49437,89.18817,55430
1448,bergmeister,1,0.00180,49438,89.18997,55430
1449,BesartSulejmani,1,0.00180,49439,89.19177,55430
1450,bethdevopsbunny,1,0.00180,49440,89.19358,55430
1451,bgastinne-algolia,1,0.00180,49441,89.19538,55430
1452,Bharathkumarraju,1,0.00180,49442,89.19719,55430
1453,bhean,1,0.00180,49443,89.19899,55430
1454,bianyifan,1,0.00180,49444,89.20079,55430
1455,bilalq,1,0.00180,49445,89.20260,55430
1456,binarymatt,1,0.00180,49446,89.20440,55430
1457,Binimow,1,0.00180,49447,89.20621,55430
1458,bitbier,1,0.00180,49448,89.20801,55430
1459,bjoe88,1,0.00180,49449,89.20981,55430
1460,BjornvdLaan,1,0.00180,49450,89.21162,55430
1461,bl1nk,1,0.00180,49451,89.21342,55430
1462,blarsen,1,0.00180,49452,89.21523,55430
1463,Blefish,1,0.00180,49453,89.21703,55430
1464,blevkovych,1,0.00180,49454,89.21883,55430
1465,b-milescu,1,0.00180,49455,89.22064,55430
1466,bnaydenov,1,0.00180,49456,89.22244,55430
1467,Bo98,1,0.00180,49457,89.22425,55430
1468,bocan,1,0.00180,49458,89.22605,55430
1469,booi,1,0.00180,49459,89.22785,55430
1470,borgified,1,0.00180,49460,89.22966,55430
1471,borisovano,1,0.00180,49461,89.23146,55430
1472,bosc0,1,0.00180,49462,89.23327,55430
1473,bosorawis,1,0.00180,49463,89.23507,55430
1474,box-as,1,0.00180,49464,89.23688,55430
1475,bPhysicist,1,0.00180,49465,89.23868,55430
1476,br3ndonland,1,0.00180,49466,89.24048,55430
1477,brainsik,1,0.00180,49467,89.24229,55430
1478,brandonpollack23,1,0.00180,49468,89.24409,55430
1479,BRAVO68WEB,1,0.00180,49469,89.24590,55430
1480,breml,1,0.00180,49470,89.24770,55430
1481,BrendanThompson,1,0.00180,49471,89.24950,55430
1482,brenthc,1,0.00180,49472,89.25131,55430
1483,BroderPeters,1,0.00180,49473,89.25311,55430
1484,bruceadowns,1,0.00180,49474,89.25492,55430
1485,bsamsom,1,0.00180,49475,89.25672,55430
1486,bsanders,1,0.00180,49476,89.25852,55430
1487,bsf25,1,0.00180,49477,89.26033,55430
1488,bsgrigorov,1,0.00180,49478,89.26213,55430
1489,bstriner,1,0.00180,49479,89.26394,55430
1490,bt909,1,0.00180,49480,89.26574,55430
1491,btajuddin,1,0.00180,49481,89.26754,55430
1492,btanand,1,0.00180,49482,89.26935,55430
1493,btpemercier,1,0.00180,49483,89.27115,55430
1494,BuJo,1,0.00180,49484,89.27296,55430
1495,bulanov,1,0.00180,49485,89.27476,55430
1496,burakcansizoglu,1,0.00180,49486,89.27657,55430
1497,burib,1,0.00180,49487,89.27837,55430
1498,burnjake,1,0.00180,49488,89.28017,55430
1499,Buzer,1,0.00180,49489,89.28198,55430
1500,bwhaley,1,0.00180,49490,89.28378,55430
1501,c3JpbmkK,1,0.00180,49491,89.28559,55430
1502,c4lliope,1,0.00180,49492,89.28739,55430
1503,caerulescens,1,0.00180,49493,89.28919,55430
1504,cal1b4n,1,0.00180,49494,89.29100,55430
1505,cancom-oss,1,0.00180,49495,89.29280,55430
1506,can-er,1,0.00180,49496,89.29461,55430
1507,canori01,1,0.00180,49497,89.29641,55430
1508,capdeploy,1,0.00180,49498,89.29821,55430
1509,captainhook,1,0.00180,49499,89.30002,55430
1510,carcher5432,1,0.00180,49500,89.30182,55430
1511,carlosgaldino,1,0.00180,49501,89.30363,55430
1512,carlosrodgut,1,0.00180,49502,89.30543,55430
1513,Carrvin,1,0.00180,49503,89.30723,55430
1514,cartmandos,1,0.00180,49504,89.30904,55430
1515,case-k-git,1,0.00180,49505,89.31084,55430
1516,cashewna,1,0.00180,49506,89.31265,55430
1517,casualuser,1,0.00180,49507,89.31445,55430
1518,catouc,1,0.00180,49508,89.31625,55430
1519,cberge908,1,0.00180,49509,89.31806,55430
1520,cblegare,1,0.00180,49510,89.31986,55430
1521,ccq1994,1,0.00180,49511,89.32167,55430
1522,cdnarbona,1,0.00180,49512,89.32347,55430
1523,CdnCentreForChildProtection,1,0.00180,49513,89.32528,55430
1524,cdsre,1,0.00180,49514,89.32708,55430
1525,cedarkuo,1,0.00180,49515,89.32888,55430
1526,centinel,1,0.00180,49516,89.33069,55430
1527,chamilad,1,0.00180,49517,89.33249,55430
1528,Chandra2614,1,0.00180,49518,89.33430,55430
1529,chanfi0ne,1,0.00180,49519,89.33610,55430
1530,ChannyClaus,1,0.00180,49520,89.33790,55430
1531,charles-ferguson,1,0.00180,49521,89.33971,55430
1532,charlie-haley,1,0.00180,49522,89.34151,55430
1533,CheeseMite,1,0.00180,49523,89.34332,55430
1534,cheoarana,1,0.00180,49524,89.34512,55430
1535,chester89,1,0.00180,49525,89.34692,55430
1536,chimons,1,0.00180,49526,89.34873,55430
1537,chirags101,1,0.00180,49527,89.35053,55430
1538,chiranjeevivarma3,1,0.00180,49528,89.35234,55430
1539,chrisandrews7,1,0.00180,49529,89.35414,55430
1540,chris-argo,1,0.00180,49530,89.35594,55430
1541,chrisbecke,1,0.00180,49531,89.35775,55430
1542,chrisbrady,1,0.00180,49532,89.35955,55430
1543,chrisbrowning,1,0.00180,49533,89.36136,55430
1544,ChrisChV,1,0.00180,49534,89.36316,55430
1545,chris-hut,1,0.00180,49535,89.36496,55430
1546,chrisk314,1,0.00180,49536,89.36677,55430
1547,chris-peterson,1,0.00180,49537,89.36857,55430
1548,christian-calabrese,1,0.00180,49538,89.37038,55430
1549,chris-troupe,1,0.00180,49539,89.37218,55430
1550,chuajiesheng,1,0.00180,49540,89.37399,55430
1551,cjgajard,1,0.00180,49541,89.37579,55430
1552,cjpablo92,1,0.00180,49542,89.37759,55430
1553,ckite,1,0.00180,49543,89.37940,55430
1554,cl1ntr0n,1,0.00180,49544,89.38120,55430
1555,clementd64,1,0.00180,49545,89.38301,55430
1556,closedtofu,1,0.00180,49546,89.38481,55430
1557,cloudlena,1,0.00180,49547,89.38661,55430
1558,clovexx,1,0.00180,49548,89.38842,55430
1559,ClusterDaemon,1,0.00180,49549,89.39022,55430
1560,cmelo05,1,0.00180,49550,89.39203,55430
1561,cnhbliyou,1,0.00180,49551,89.39383,55430
1562,codyhod,1,0.00180,49552,89.39563,55430
1563,codymaust,1,0.00180,49553,89.39744,55430
1564,cogwirrel,1,0.00180,49554,89.39924,55430
1565,coingraham,1,0.00180,49555,89.40105,55430
1566,colemanja91,1,0.00180,49556,89.40285,55430
1567,colinfish-toast,1,0.00180,49557,89.40465,55430
1568,colmac-thomasops,1,0.00180,49558,89.40646,55430
1569,comerford,1,0.00180,49559,89.40826,55430
1570,computerlove,1,0.00180,49560,89.41007,55430
1571,comtef,1,0.00180,49561,89.41187,55430
1572,coolbeans201,1,0.00180,49562,89.41367,55430
1573,coreydeli,1,0.00180,49563,89.41548,55430
1574,cornerman,1,0.00180,49564,89.41728,55430
1575,cornerot,1,0.00180,49565,89.41909,55430
1576,corymhall,1,0.00180,49566,89.42089,55430
1577,corym-vermeer,1,0.00180,49567,89.42270,55430
1578,cosmindrimba,1,0.00180,49568,89.42450,55430
1579,cprakasu,1,0.00180,49569,89.42630,55430
1580,cpressland,1,0.00180,49570,89.42811,55430
1581,craigthackerx,1,0.00180,49571,89.42991,55430
1582,crazymushrooms,1,0.00180,49572,89.43172,55430
1583,crhino,1,0.00180,49573,89.43352,55430
1584,cr-klarna,1,0.00180,49574,89.43532,55430
1585,cropalato,1,0.00180,49575,89.43713,55430
1586,crypto-br,1,0.00180,49576,89.43893,55430
1587,cschar,1,0.00180,49577,89.44074,55430
1588,ctizen,1,0.00180,49578,89.44254,55430
1589,ctvanzandt42,1,0.00180,49579,89.44434,55430
1590,cybrkit,1,0.00180,49580,89.44615,55430
1591,Cyclenerd,1,0.00180,49581,89.44795,55430
1592,cyrilgdn,1,0.00180,49582,89.44976,55430
1593,d3vilh,1,0.00180,49583,89.45156,55430
1594,dabmajor,1,0.00180,49584,89.45336,55430
1595,dacut,1,0.00180,49585,89.45517,55430
1596,dadangnh,1,0.00180,49586,89.45697,55430
1597,dahnlka,1,0.00180,49587,89.45878,55430
1598,danbarr,1,0.00180,49588,89.46058,55430
1599,dani-chmb,1,0.00180,49589,89.46238,55430
1600,daniel-edwards-nz,1,0.00180,49590,89.46419,55430
1601,daniel-finisterra,1,0.00180,49591,89.46599,55430
1602,danielgmyers-figma,1,0.00180,49592,89.46780,55430
1603,DanielHabenicht,1,0.00180,49593,89.46960,55430
1604,danieljharris,1,0.00180,49594,89.47141,55430
1605,danieljsaldana,1,0.00180,49595,89.47321,55430
1606,Daniellem97,1,0.00180,49596,89.47501,55430
1607,DanielMSchmidt,1,0.00180,49597,89.47682,55430
1608,danielsanchezd,1,0.00180,49598,89.47862,55430
1609,DanyaSh,1,0.00180,49599,89.48043,55430
1610,danydev,1,0.00180,49600,89.48223,55430
1611,DarkAtra,1,0.00180,49601,89.48403,55430
1612,darkcloud358,1,0.00180,49602,89.48584,55430
1613,Darkhenrhal,1,0.00180,49603,89.48764,55430
1614,darpham,1,0.00180,49604,89.48945,55430
1615,dasaditya07,1,0.00180,49605,89.49125,55430
1616,d-averkiev,1,0.00180,49606,89.49305,55430
1617,DavidShefcik,1,0.00180,49607,89.49486,55430
1618,davimmt,1,0.00180,49608,89.49666,55430
1619,Daxenirean,1,0.00180,49609,89.49847,55430
1620,dbhaigh,1,0.00180,49610,89.50027,55430
1621,dcabaceira,1,0.00180,49611,89.50207,55430
1622,dcristobalhMad,1,0.00180,49612,89.50388,55430
1623,ddias00,1,0.00180,49613,89.50568,55430
1624,ddouglas,1,0.00180,49614,89.50749,55430
1625,default300,1,0.00180,49615,89.50929,55430
1626,definitepotato,1,0.00180,49616,89.51110,55430
1627,deichindianer,1,0.00180,49617,89.51290,55430
1628,Demivan,1,0.00180,49618,89.51470,55430
1629,denischiparus,1,0.00180,49619,89.51651,55430
1630,denmanveer,1,0.00180,49620,89.51831,55430
1631,dennislapchenko,1,0.00180,49621,89.52012,55430
1632,densanki,1,0.00180,49622,89.52192,55430
1633,derekmckinnon,1,0.00180,49623,89.52372,55430
1634,DerekTBrown,1,0.00180,49624,89.52553,55430
1635,derytim,1,0.00180,49625,89.52733,55430
1636,Dessix,1,0.00180,49626,89.52914,55430
1637,desutterf,1,0.00180,49627,89.53094,55430
1638,devbijay,1,0.00180,49628,89.53274,55430
1639,devbyaccident,1,0.00180,49629,89.53455,55430
1640,devopsmerc,1,0.00180,49630,89.53635,55430
1641,dflook,1,0.00180,49631,89.53816,55430
1642,dgershman,1,0.00180,49632,89.53996,55430
1643,dglsparsons,1,0.00180,49633,89.54176,55430
1644,dgreisen,1,0.00180,49634,89.54357,55430
1645,dhanupimpalkar1,1,0.00180,49635,89.54537,55430
1646,dhanushcodie,1,0.00180,49636,89.54718,55430
1647,dharmendrasha,1,0.00180,49637,89.54898,55430
1648,dhasenan,1,0.00180,49638,89.55078,55430
1649,Diana22hryshyna,1,0.00180,49639,89.55259,55430
1650,dianibar,1,0.00180,49640,89.55439,55430
1651,diegofd,1,0.00180,49641,89.55620,55430
1652,digglife,1,0.00180,49642,89.55800,55430
1653,digitalfiz,1,0.00180,49643,89.55981,55430
1654,digitalghost-dev,1,0.00180,49644,89.56161,55430
1655,digorbunov,1,0.00180,49645,89.56341,55430
1656,dimapaloskin,1,0.00180,49646,89.56522,55430
1657,dimbleby,1,0.00180,49647,89.56702,55430
1658,diogoab,1,0.00180,49648,89.56883,55430
1659,Dionmm,1,0.00180,49649,89.57063,55430
1660,dippas,1,0.00180,49650,89.57243,55430
1661,Dirrbick,1,0.00180,49651,89.57424,55430
1662,dkanbier,1,0.00180,49652,89.57604,55430
1663,dkatona4,1,0.00180,49653,89.57785,55430
1664,dkuzmenok,1,0.00180,49654,89.57965,55430
1665,dmaclaury,1,0.00180,49655,89.58145,55430
1666,DmarshalTU,1,0.00180,49656,89.58326,55430
1667,DMaxter,1,0.00180,49657,89.58506,55430
1668,DMEvanCT,1,0.00180,49658,89.58687,55430
1669,DmitryMaletin,1,0.00180,49659,89.58867,55430
1670,dmytrobraha,1,0.00180,49660,89.59047,55430
1671,dnaploszek,1,0.00180,49661,89.59228,55430
1672,dnogu,1,0.00180,49662,89.59408,55430
1673,docbyte86,1,0.00180,49663,89.59589,55430
1674,DoctorOgg,1,0.00180,49664,89.59769,55430
1675,Dolape1983,1,0.00180,49665,89.59949,55430
1676,dongho-jung,1,0.00180,49666,89.60130,55430
1677,dormunis,1,0.00180,49667,89.60310,55430
1678,dotanalter,1,0.00180,49668,89.60491,55430
1679,dottedmag,1,0.00180,49669,89.60671,55430
1680,dp-152,1,0.00180,49670,89.60852,55430
1681,dpirotte,1,0.00180,49671,89.61032,55430
1682,dpshnv,1,0.00180,49672,89.61212,55430
1683,Draiget,1,0.00180,49673,89.61393,55430
1684,draring,1,0.00180,49674,89.61573,55430
1685,drdev,1,0.00180,49675,89.61754,55430
1686,dresswithpockets,1,0.00180,49676,89.61934,55430
1687,drewxs,1,0.00180,49677,89.62114,55430
1688,DROFBOT,1,0.00180,49678,89.62295,55430
1689,drudgesentinel,1,0.00180,49679,89.62475,55430
1690,drupler,1,0.00180,49680,89.62656,55430
1691,dshelley66,1,0.00180,49681,89.62836,55430
1692,DSollick,1,0.00180,49682,89.63016,55430
1693,dstrates,1,0.00180,49683,89.63197,55430
1694,dthvt,1,0.00180,49684,89.63377,55430
1695,duncan3dc,1,0.00180,49685,89.63558,55430
1696,duncanpharvey,1,0.00180,49686,89.63738,55430
1697,duntonr,1,0.00180,49687,89.63918,55430
1698,duoxoud,1,0.00180,49688,89.64099,55430
1699,durehed,1,0.00180,49689,89.64279,55430
1700,dyadMisha,1,0.00180,49690,89.64460,55430
1701,dylanaxcelerate,1,0.00180,49691,89.64640,55430
1702,dylan-way,1,0.00180,49692,89.64820,55430
1703,eadderley,1,0.00180,49693,89.65001,55430
1704,ebel,1,0.00180,49694,89.65181,55430
1705,EdanBrooke,1,0.00180,49695,89.65362,55430
1706,edif2008,1,0.00180,49696,89.65542,55430
1707,edwardofclt,1,0.00180,49697,89.65723,55430
1708,efemaer,1,0.00180,49698,89.65903,55430
1709,egorksv,1,0.00180,49699,89.66083,55430
1710,ei-grad,1,0.00180,49700,89.66264,55430
1711,Eirik84,1,0.00180,49701,89.66444,55430
1712,ekini,1,0.00180,49702,89.66625,55430
1713,el841,1,0.00180,49703,89.66805,55430
1714,Elandig,1,0.00180,49704,89.66985,55430
1715,elbombardi,1,0.00180,49705,89.67166,55430
1716,eliecharra,1,0.00180,49706,89.67346,55430
1717,elijah,1,0.00180,49707,89.67527,55430
1718,elijaholmos,1,0.00180,49708,89.67707,55430
1719,eltalkarim,1,0.00180,49709,89.67887,55430
1720,emanuelschmoczer,1,0.00180,49710,89.68068,55430
1721,emanzek,1,0.00180,49711,89.68248,55430
1722,emerchalegre,1,0.00180,49712,89.68429,55430
1723,emito-k,1,0.00180,49713,89.68609,55430
1724,emnet-crl,1,0.00180,49714,89.68789,55430
1725,EndureBlackout,1,0.00180,49715,89.68970,55430
1726,eniolastyle,1,0.00180,49716,89.69150,55430
1727,EnvyIT,1,0.00180,49717,89.69331,55430
1728,epbensimpson,1,0.00180,49718,89.69511,55430
1729,eran-infralight,1,0.00180,49719,89.69692,55430
1730,ergihu,1,0.00180,49720,89.69872,55430
1731,ErgoPr0xy,1,0.00180,49721,89.70052,55430
1732,EricBoily,1,0.00180,49722,89.70233,55430
1733,eric-gonzales,1,0.00180,49723,89.70413,55430
1734,ericvs,1,0.00180,49724,89.70594,55430
1735,erjdev,1,0.00180,49725,89.70774,55430
1736,erlisb,1,0.00180,49726,89.70954,55430
1737,Ernyoke,1,0.00180,49727,89.71135,55430
1738,erouan50,1,0.00180,49728,89.71315,55430
1739,erz4,1,0.00180,49729,89.71496,55430
1740,eshneken,1,0.00180,49730,89.71676,55430
1741,essjayhch,1,0.00180,49731,89.71856,55430
1742,etki,1,0.00180,49732,89.72037,55430
1743,eudaldgr,1,0.00180,49733,89.72217,55430
1744,EValge-IT,1,0.00180,49734,89.72398,55430
1745,evan-cleary,1,0.00180,49735,89.72578,55430
1746,evgeniyprudchenko,1,0.00180,49736,89.72758,55430
1747,evgenymarkov,1,0.00180,49737,89.72939,55430
1748,evilgn0me,1,0.00180,49738,89.73119,55430
1749,evoxmusic,1,0.00180,49739,89.73300,55430
1750,ewencodes,1,0.00180,49740,89.73480,55430
1751,Excoriate,1,0.00180,49741,89.73660,55430
1752,faekiva,1,0.00180,49742,89.73841,55430
1753,fahadahammed,1,0.00180,49743,89.74021,55430
1754,faheymann,1,0.00180,49744,89.74202,55430
1755,far-rainbow,1,0.00180,49745,89.74382,55430
1756,fatihtokus,1,0.00180,49746,89.74563,55430
1757,faust93,1,0.00180,49747,89.74743,55430
1758,fclemonschool,1,0.00180,49748,89.74923,55430
1759,fdmsantos,1,0.00180,49749,89.75104,55430
1760,fedya,1,0.00180,49750,89.75284,55430
1761,felipefreitas,1,0.00180,49751,89.75465,55430
1762,felipefreitasdeoliveira,1,0.00180,49752,89.75645,55430
1763,felipekj,1,0.00180,49753,89.75825,55430
1764,felipempda,1,0.00180,49754,89.76006,55430
1765,felixb,1,0.00180,49755,89.76186,55430
1766,Felix-Franz,1,0.00180,49756,89.76367,55430
1767,FelixWaweru,1,0.00180,49757,89.76547,55430
1768,fergoid,1,0.00180,49758,89.76727,55430
1769,fernandososter,1,0.00180,49759,89.76908,55430
1770,FeroVolar,1,0.00180,49760,89.77088,55430
1771,filol,1,0.00180,49761,89.77269,55430
1772,finalduty,1,0.00180,49762,89.77449,55430
1773,finallyRaunak,1,0.00180,49763,89.77629,55430
1774,fingalickn,1,0.00180,49764,89.77810,55430
1775,fitsnips,1,0.00180,49765,89.77990,55430
1776,flamelcadet,1,0.00180,49766,89.78171,55430
1777,flasheh,1,0.00180,49767,89.78351,55430
1778,flex-seongmin,1,0.00180,49768,89.78531,55430
1779,flichtenheld,1,0.00180,49769,89.78712,55430
1780,florianakos,1,0.00180,49770,89.78892,55430
1781,florian-forestier,1,0.00180,49771,89.79073,55430
1782,FollieHiyuki,1,0.00180,49772,89.79253,55430
1783,fostemi,1,0.00180,49773,89.79434,55430
1784,fourleaftec,1,0.00180,49774,89.79614,55430
1785,fpighi,1,0.00180,49775,89.79794,55430
1786,Fraetor,1,0.00180,49776,89.79975,55430
1787,francescovallone,1,0.00180,49777,89.80155,55430
1788,francjp,1,0.00180,49778,89.80336,55430
1789,frco9,1,0.00180,49779,89.80516,55430
1790,frct1,1,0.00180,49780,89.80696,55430
1791,frediana,1,0.00180,49781,89.80877,55430
1792,fredouric,1,0.00180,49782,89.81057,55430
1793,fredpena,1,0.00180,49783,89.81238,55430
1794,fredrikekre,1,0.00180,49784,89.81418,55430
1795,Freezerno,1,0.00180,49785,89.81598,55430
1796,freundTech,1,0.00180,49786,89.81779,55430
1797,freylafert,1,0.00180,49787,89.81959,55430
1798,Frikki,1,0.00180,49788,89.82140,55430
1799,FritzDVL,1,0.00180,49789,89.82320,55430
1800,frodyan,1,0.00180,49790,89.82500,55430
1801,frosforever,1,0.00180,49791,89.82681,55430
1802,frostsxx,1,0.00180,49792,89.82861,55430
1803,fuad-ahmed,1,0.00180,49793,89.83042,55430
1804,furkhat,1,0.00180,49794,89.83222,55430
1805,Fydon,1,0.00180,49795,89.83402,55430
1806,fyqtian,1,0.00180,49796,89.83583,55430
1807,Gabri,1,0.00180,49797,89.83763,55430
1808,gabriellaneris,1,0.00180,49798,89.83944,55430
1809,gabrielpulga,1,0.00180,49799,89.84124,55430
1810,gagan-bhullar-tech,1,0.00180,49800,89.84305,55430
1811,galperinm,1,0.00180,49801,89.84485,55430
1812,galvarado,1,0.00180,49802,89.84665,55430
1813,garymcleanuk,1,0.00180,49803,89.84846,55430
1814,garysassano,1,0.00180,49804,89.85026,55430
1815,GavinWu1991,1,0.00180,49805,89.85207,55430
1816,gayanhewa,1,0.00180,49806,89.85387,55430
1817,gbrlsnchs,1,0.00180,49807,89.85567,55430
1818,gbschenkel,1,0.00180,49808,89.85748,55430
1819,GEK62,1,0.00180,49809,89.85928,55430
1820,generalconsensus-omf,1,0.00180,49810,89.86109,55430
1821,gephaest,1,0.00180,49811,89.86289,55430
1822,GerardSoleCa,1,0.00180,49812,89.86469,55430
1823,gercograndia,1,0.00180,49813,89.86650,55430
1824,geronimo-iia,1,0.00180,49814,89.86830,55430
1825,gerschinner,1,0.00180,49815,89.87011,55430
1826,ghorbani-ali,1,0.00180,49816,89.87191,55430
1827,giacomo-ca,1,0.00180,49817,89.87371,55430
1828,gifkoek-fargo,1,0.00180,49818,89.87552,55430
1829,gileri,1,0.00180,49819,89.87732,55430
1830,gitgudchannel,1,0.00180,49820,89.87913,55430
1831,glenux,1,0.00180,49821,89.88093,55430
1832,glisav,1,0.00180,49822,89.88273,55430
1833,glli01,1,0.00180,49823,89.88454,55430
1834,godev02,1,0.00180,49824,89.88634,55430
1835,GoozeyX,1,0.00180,49825,89.88815,55430
1836,graemechristie,1,0.00180,49826,89.88995,55430
1837,GrakovNe,1,0.00180,49827,89.89176,55430
1838,Grawern,1,0.00180,49828,89.89356,55430
1839,greatbn,1,0.00180,49829,89.89536,55430
1840,grebnebo,1,0.00180,49830,89.89717,55430
1841,greeneg,1,0.00180,49831,89.89897,55430
1842,gregorlogar991,1,0.00180,49832,89.90078,55430
1843,gregoryca,1,0.00180,49833,89.90258,55430
1844,grem11n,1,0.00180,49834,89.90438,55430
1845,Grmiade,1,0.00180,49835,89.90619,55430
1846,g-s-eire,1,0.00180,49836,89.90799,55430
1847,guillaume-dussault,1,0.00180,49837,89.90980,55430
1848,guillermo-sentinella,1,0.00180,49838,89.91160,55430
1849,gungoren,1,0.00180,49839,89.91340,55430
1850,gusfune,1,0.00180,49840,89.91521,55430
1851,GuusDeGraeve,1,0.00180,49841,89.91701,55430
1852,hacker65536,1,0.00180,49842,89.91882,55430
1853,HadrienPatte,1,0.00180,49843,89.92062,55430
1854,haggishunk,1,0.00180,49844,89.92242,55430
1855,HaigNalbandian,1,0.00180,49845,89.92423,55430
1856,hamishforbes,1,0.00180,49846,89.92603,55430
1857,hammer-bin,1,0.00180,49847,89.92784,55430
1858,hamonangann,1,0.00180,49848,89.92964,55430
1859,harrisin2037,1,0.00180,49849,89.93145,55430
1860,harrymyburgh,1,0.00180,49850,89.93325,55430
1861,harshsingh32,1,0.00180,49851,89.93505,55430
1862,haru-mamburu,1,0.00180,49852,89.93686,55430
1863,hashi-derek,1,0.00180,49853,89.93866,55430
1864,HassanMahmud,1,0.00180,49854,89.94047,55430
1865,Haydn202,1,0.00180,49855,89.94227,55430
1866,hbjydev,1,0.00180,49856,89.94407,55430
1867,hbuckle,1,0.00180,49857,89.94588,55430
1868,hchan,1,0.00180,49858,89.94768,55430
1869,hcoberdalhoff,1,0.00180,49859,89.94949,55430
1870,headerl0gged,1,0.00180,49860,89.95129,55430
1871,hectorvent,1,0.00180,49861,89.95309,55430
1872,heinhtetwin,1,0.00180,49862,89.95490,55430
1873,henare,1,0.00180,49863,89.95670,55430
1874,henkka,1,0.00180,49864,89.95851,55430
1875,henriquelucasdf,1,0.00180,49865,89.96031,55430
1876,henryk-rychlik,1,0.00180,49866,89.96211,55430
1877,henworth,1,0.00180,49867,89.96392,55430
1878,HerrSubset,1,0.00180,49868,89.96572,55430
1879,hertznsk,1,0.00180,49869,89.96753,55430
1880,Hexy32,1,0.00180,49870,89.96933,55430
1881,hfinucane-zscaler,1,0.00180,49871,89.97113,55430
1882,hfm,1,0.00180,49872,89.97294,55430
1883,hieudp,1,0.00180,49873,89.97474,55430
1884,hilariocoelho,1,0.00180,49874,89.97655,55430
1885,hilyas,1,0.00180,49875,89.97835,55430
1886,hitofuji,1,0.00180,49876,89.98016,55430
1887,hkamran80,1,0.00180,49877,89.98196,55430
1888,hlange4,1,0.00180,49878,89.98376,55430
1889,hmrc87,1,0.00180,49879,89.98557,55430
1890,honeyyadav,1,0.00180,49880,89.98737,55430
1891,HonkingGoose,1,0.00180,49881,89.98918,55430
1892,horizonnet,1,0.00180,49882,89.99098,55430
1893,hrueschwein,1,0.00180,49883,89.99278,55430
1894,hskiba,1,0.00180,49884,89.99459,55430
1895,hsmtkk,1,0.00180,49885,89.99639,55430
1896,htamakos,1,0.00180,49886,89.99820,55430
1897,hube12,1,0.00180,49887,90.00000,55430
1898,Hugh----,1,0.00180,49888,90.00180,55430
1899,hunttom,1,0.00180,49889,90.00361,55430
1900,husunal,1,0.00180,49890,90.00541,55430
1901,huynhcongdanh,1,0.00180,49891,90.00722,55430
1902,hvbamzn,1,0.00180,49892,90.00902,55430
1903,hver,1,0.00180,49893,90.01082,55430
1904,IamMrCupp,1,0.00180,49894,90.01263,55430
1905,ia-Simon,1,0.00180,49895,90.01443,55430
1906,ibenrodriguez,1,0.00180,49896,90.01624,55430
1907,icfai-aniketsingh,1,0.00180,49897,90.01804,55430
1908,ignoraunt,1,0.00180,49898,90.01984,55430
1909,igorcoding,1,0.00180,49899,90.02165,55430
1910,IgorEulalio,1,0.00180,49900,90.02345,55430
1911,igorkliushnikov,1,0.00180,49901,90.02526,55430
1912,Ihab-Zhaika,1,0.00180,49902,90.02706,55430
1913,ikegentz,1,0.00180,49903,90.02887,55430
1914,ilhame90,1,0.00180,49904,90.03067,55430
1915,ili16,1,0.00180,49905,90.03247,55430
1916,ilyasd3,1,0.00180,49906,90.03428,55430
1917,ilyesAj,1,0.00180,49907,90.03608,55430
1918,imaginaryCorn,1,0.00180,49908,90.03789,55430
1919,im-bruno,1,0.00180,49909,90.03969,55430
1920,imhyeons,1,0.00180,49910,90.04149,55430
1921,imjaroiswebdev,1,0.00180,49911,90.04330,55430
1922,implodingduck,1,0.00180,49912,90.04510,55430
1923,imrtfm,1,0.00180,49913,90.04691,55430
1924,inaun,1,0.00180,49914,90.04871,55430
1925,infectiious,1,0.00180,49915,90.05051,55430
1926,Infiniteez,1,0.00180,49916,90.05232,55430
1927,inisitijitty,1,0.00180,49917,90.05412,55430
1928,initializ-mk,1,0.00180,49918,90.05593,55430
1929,InNickF,1,0.00180,49919,90.05773,55430
1930,iodeslykos,1,0.00180,49920,90.05953,55430
1931,ionfury,1,0.00180,49921,90.06134,55430
1932,Isaac-Bi,1,0.00180,49922,90.06314,55430
1933,Ishdril,1,0.00180,49923,90.06495,55430
1934,iskey,1,0.00180,49924,90.06675,55430
1935,ismail44,1,0.00180,49925,90.06855,55430
1936,itd-seb,1,0.00180,49926,90.07036,55430
1937,itsmePoorva,1,0.00180,49927,90.07216,55430
1938,itsmontoya,1,0.00180,49928,90.07397,55430
1939,itsnicksia,1,0.00180,49929,90.07577,55430
1940,ItsYou,1,0.00180,49930,90.07758,55430
1941,IvanKirpichnikov,1,0.00180,49931,90.07938,55430
1942,ivan-vorona,1,0.00180,49932,90.08118,55430
1943,ixth,1,0.00180,49933,90.08299,55430
1944,j0n47h4n,1,0.00180,49934,90.08479,55430
1945,jacek-28,1,0.00180,49935,90.08660,55430
1946,jackarmorgie,1,0.00180,49936,90.08840,55430
1947,jackishere,1,0.00180,49937,90.09020,55430
1948,jakobkubicki,1,0.00180,49938,90.09201,55430
1949,JakubBialoskorski,1,0.00180,49939,90.09381,55430
1950,jakubramut,1,0.00180,49940,90.09562,55430
1951,jalavoy,1,0.00180,49941,90.09742,55430
1952,JamesBelchamber,1,0.00180,49942,90.09922,55430
1953,jamescaldow,1,0.00180,49943,90.10103,55430
1954,jandersen-plaid,1,0.00180,49944,90.10283,55430
1955,janickrohrbach,1,0.00180,49945,90.10464,55430
1956,JanKoppe,1,0.00180,49946,90.10644,55430
1957,JannoTjarks,1,0.00180,49947,90.10824,55430
1958,jaredbrogan,1,0.00180,49948,90.11005,55430
1959,jarijokinen,1,0.00180,49949,90.11185,55430
1960,jarv,1,0.00180,49950,90.11366,55430
1961,jasnoyaeger,1,0.00180,49951,90.11546,55430
1962,jasonyoung-pearl,1,0.00180,49952,90.11727,55430
1963,Jason-Zhang9309,1,0.00180,49953,90.11907,55430
1964,javi-corbin,1,0.00180,49954,90.12087,55430
1965,jayctran,1,0.00180,49955,90.12268,55430
1966,jayden-csyu,1,0.00180,49956,90.12448,55430
1967,JaydonSunley,1,0.00180,49957,90.12629,55430
1968,jay-lark,1,0.00180,49958,90.12809,55430
1969,Jaypers,1,0.00180,49959,90.12989,55430
1970,jbobbylopez,1,0.00180,49960,90.13170,55430
1971,jcanizalez,1,0.00180,49961,90.13350,55430
1972,jciskey,1,0.00180,49962,90.13531,55430
1973,jdelnano,1,0.00180,49963,90.13711,55430
1974,JDMetal,1,0.00180,49964,90.13891,55430
1975,jdoetsch-built,1,0.00180,49965,90.14072,55430
1976,Jedi-5,1,0.00180,49966,90.14252,55430
1977,jeffallen,1,0.00180,49967,90.14433,55430
1978,JeffAlyanak,1,0.00180,49968,90.14613,55430
1979,jeffmaley,1,0.00180,49969,90.14793,55430
1980,jeff-mccoy,1,0.00180,49970,90.14974,55430
1981,jeffrade,1,0.00180,49971,90.15154,55430
1982,JeftavanderHorst,1,0.00180,49972,90.15335,55430
1983,jeremmfr,1,0.00180,49973,90.15515,55430
1984,jfmrm,1,0.00180,49974,90.15695,55430
1985,Jgeissler14,1,0.00180,49975,90.15876,55430
1986,JHansen2000,1,0.00180,49976,90.16056,55430
1987,jharter1,1,0.00180,49977,90.16237,55430
1988,JHBaik,1,0.00180,49978,90.16417,55430
1989,jhisc,1,0.00180,49979,90.16598,55430
1990,jhixson74,1,0.00180,49980,90.16778,55430
1991,jidejones,1,0.00180,49981,90.16958,55430
1992,jimdiroffii,1,0.00180,49982,90.17139,55430
1993,jimjag,1,0.00180,49983,90.17319,55430
1994,jirislav,1,0.00180,49984,90.17500,55430
1995,jishnusygal,1,0.00180,49985,90.17680,55430
1996,jkataja,1,0.00180,49986,90.17860,55430
1997,jkcdarunday,1,0.00180,49987,90.18041,55430
1998,jleight,1,0.00180,49988,90.18221,55430
1999,JM2K69,1,0.00180,49989,90.18402,55430
2000,jmkeyes,1,0.00180,49990,90.18582,55430
2001,jmonte-sph,1,0.00180,49991,90.18762,55430
2002,jnsaff,1,0.00180,49992,90.18943,55430
2003,JoeeGrigg,1,0.00180,49993,90.19123,55430
2004,joe-hutchinson-cko,1,0.00180,49994,90.19304,55430
2005,joelio,1,0.00180,49995,90.19484,55430
2006,joemiao-exos,1,0.00180,49996,90.19664,55430
2007,joe-niland,1,0.00180,49997,90.19845,55430
2008,JoeVaughan96,1,0.00180,49998,90.20025,55430
2009,johnalvero,1,0.00180,49999,90.20206,55430
2010,johnathon-b,1,0.00180,50000,90.20386,55430
2011,johntdyer,1,0.00180,50001,90.20566,55430
2012,jonas-budde,1,0.00180,50002,90.20747,55430
2013,jonataaraujo,1,0.00180,50003,90.20927,55430
2014,jonathanweinberg,1,0.00180,50004,90.21108,55430
2015,joonvena,1,0.00180,50005,90.21288,55430
2016,joosangkim,1,0.00180,50006,90.21469,55430
2017,jordyverbeek,1,0.00180,50007,90.21649,55430
2018,jorgemarey,1,0.00180,50008,90.21829,55430
2019,josecmojap,1,0.00180,50009,90.22010,55430
2020,JosephMcGreene,1,0.00180,50010,90.22190,55430
2021,joseph-wortmann,1,0.00180,50011,90.22371,55430
2022,josh-barker,1,0.00180,50012,90.22551,55430
2023,joshd-emergent,1,0.00180,50013,90.22731,55430
2024,joshmello,1,0.00180,50014,90.22912,55430
2025,joshpollara,1,0.00180,50015,90.23092,55430
2026,joshrwolf,1,0.00180,50016,90.23273,55430
2027,joshuashanks-sentilink,1,0.00180,50017,90.23453,55430
2028,JoshWoodArup,1,0.00180,50018,90.23633,55430
2029,JousP,1,0.00180,50019,90.23814,55430
2030,joxpg,1,0.00180,50020,90.23994,55430
2031,jp,1,0.00180,50021,90.24175,55430
2032,jphelton,1,0.00180,50022,90.24355,55430
2033,jpmicrosoft,1,0.00180,50023,90.24535,55430
2034,jpterry,1,0.00180,50024,90.24716,55430
2035,jrakotomanga-technofy,1,0.00180,50025,90.24896,55430
2036,jrdnbradford,1,0.00180,50026,90.25077,55430
2037,jsakama,1,0.00180,50027,90.25257,55430
2038,jsantos93,1,0.00180,50028,90.25437,55430
2039,jschwanz,1,0.00180,50029,90.25618,55430
2040,jschwartzenberg,1,0.00180,50030,90.25798,55430
2041,jsphwllng,1,0.00180,50031,90.25979,55430
2042,juandiii,1,0.00180,50032,90.26159,55430
2043,juanjo-vlc,1,0.00180,50033,90.26340,55430
2044,juhala-aws,1,0.00180,50034,90.26520,55430
2045,julian-alarcon,1,0.00180,50035,90.26700,55430
2046,justin-kidman-axomic,1,0.00180,50036,90.26881,55430
2047,justinpopa,1,0.00180,50037,90.27061,55430
2048,justinrubek,1,0.00180,50038,90.27242,55430
2049,juzerali,1,0.00180,50039,90.27422,55430
2050,jwalsh2me,1,0.00180,50040,90.27602,55430
2051,jweigand,1,0.00180,50041,90.27783,55430
2052,jwhite-ac,1,0.00180,50042,90.27963,55430
2053,jwsy,1,0.00180,50043,90.28144,55430
2054,jylitalo,1,0.00180,50044,90.28324,55430
2055,k0eff,1,0.00180,50045,90.28504,55430
2056,k1rk,1,0.00180,50046,90.28685,55430
2057,k3y0708,1,0.00180,50047,90.28865,55430
2058,k4rtikp4til,1,0.00180,50048,90.29046,55430
2059,k5ki,1,0.00180,50049,90.29226,55430
2060,kaancceylan,1,0.00180,50050,90.29406,55430
2061,kaczenski,1,0.00180,50051,90.29587,55430
2062,k-ader,1,0.00180,50052,90.29767,55430
2063,kaitheal,1,0.00180,50053,90.29948,55430
2064,kaizen13,1,0.00180,50054,90.30128,55430
2065,Kalffman,1,0.00180,50055,90.30308,55430
2066,kamilzzz,1,0.00180,50056,90.30489,55430
2067,kamontat,1,0.00180,50057,90.30669,55430
2068,karanvircu,1,0.00180,50058,90.30850,55430
2069,karl-johan-grahn,1,0.00180,50059,90.31030,55430
2070,karnaker,1,0.00180,50060,90.31211,55430
2071,karthickdharmansa,1,0.00180,50061,90.31391,55430
2072,katafrakt,1,0.00180,50062,90.31571,55430
2073,kathmbeck,1,0.00180,50063,90.31752,55430
2074,katlol,1,0.00180,50064,90.31932,55430
2075,kaykhan,1,0.00180,50065,90.32113,55430
2076,kbcz1989,1,0.00180,50066,90.32293,55430
2077,kbr-trackunit,1,0.00180,50067,90.32473,55430
2078,keeb,1,0.00180,50068,90.32654,55430
2079,KeeganJustis,1,0.00180,50069,90.32834,55430
2080,keithpitt,1,0.00180,50070,90.33015,55430
2081,kellenanker7,1,0.00180,50071,90.33195,55430
2082,kemko,1,0.00180,50072,90.33375,55430
2083,kentkravitz,1,0.00180,50073,90.33556,55430
2084,kevin-fagan,1,0.00180,50074,90.33736,55430
2085,KevinSayers,1,0.00180,50075,90.33917,55430
2086,kgns,1,0.00180,50076,90.34097,55430
2087,kgpdt,1,0.00180,50077,90.34277,55430
2088,khaledez,1,0.00180,50078,90.34458,55430
2089,Khayoann2,1,0.00180,50079,90.34638,55430
2090,kibitan,1,0.00180,50080,90.34819,55430
2091,kieran-lowe,1,0.00180,50081,90.34999,55430
2092,Kieranties,1,0.00180,50082,90.35180,55430
2093,kilmajster,1,0.00180,50083,90.35360,55430
2094,KimTEriksson,1,0.00180,50084,90.35540,55430
2095,Kingdroid1,1,0.00180,50085,90.35721,55430
2096,kiridharan,1,0.00180,50086,90.35901,55430
2097,kirillve,1,0.00180,50087,90.36082,55430
2098,kirk-wex,1,0.00180,50088,90.36262,55430
2099,kisv-SOPTIM,1,0.00180,50089,90.36442,55430
2100,kiyota-mesh,1,0.00180,50090,90.36623,55430
2101,kkopachev,1,0.00180,50091,90.36803,55430
2102,klemmchr,1,0.00180,50092,90.36984,55430
2103,kmazurek13,1,0.00180,50093,90.37164,55430
2104,kmiracle86,1,0.00180,50094,90.37344,55430
2105,knastase,1,0.00180,50095,90.37525,55430
2106,kneekeel,1,0.00180,50096,90.37705,55430
2107,knh1,1,0.00180,50097,90.37886,55430
2108,KnutFr,1,0.00180,50098,90.38066,55430
2109,kohbis,1,0.00180,50099,90.38246,55430
2110,kolvin,1,0.00180,50100,90.38427,55430
2111,kostasns,1,0.00180,50101,90.38607,55430
2112,kota65535,1,0.00180,50102,90.38788,55430
2113,kovaacs,1,0.00180,50103,90.38968,55430
2114,Kozoft,1,0.00180,50104,90.39148,55430
2115,kratkyzobak,1,0.00180,50105,90.39329,55430
2116,krdian,1,0.00180,50106,90.39509,55430
2117,kristian-lesko,1,0.00180,50107,90.39690,55430
2118,Kroseida,1,0.00180,50108,90.39870,55430
2119,krsmanovic,1,0.00180,50109,90.40051,55430
2120,krtkvrm,1,0.00180,50110,90.40231,55430
2121,krukowskid,1,0.00180,50111,90.40411,55430
2122,kryptogeist,1,0.00180,50112,90.40592,55430
2123,krzysztof-kotewa,1,0.00180,50113,90.40772,55430
2124,ksaurabhsinha,1,0.00180,50114,90.40953,55430
2125,ksmets,1,0.00180,50115,90.41133,55430
2126,kunaksergey,1,0.00180,50116,90.41313,55430
2127,kunovsky,1,0.00180,50117,90.41494,55430
2128,kurarrr,1,0.00180,50118,90.41674,55430
2129,kush-work,1,0.00180,50119,90.41855,55430
2130,kutovoys,1,0.00180,50120,90.42035,55430
2131,kutysam,1,0.00180,50121,90.42215,55430
2132,kylebisley,1,0.00180,50122,90.42396,55430
2133,kyle-burnett,1,0.00180,50123,90.42576,55430
2134,kylewintaur,1,0.00180,50124,90.42757,55430
2135,Kyngo,1,0.00180,50125,90.42937,55430
2136,LadyDhaga,1,0.00180,50126,90.43117,55430
2137,laexiv,1,0.00180,50127,90.43298,55430
2138,lagebj,1,0.00180,50128,90.43478,55430
2139,lakrass,1,0.00180,50129,90.43659,55430
2140,Lakshan-Banneheke,1,0.00180,50130,90.43839,55430
2141,landbaychrisburrell,1,0.00180,50131,90.44019,55430
2142,langburd,1,0.00180,50132,90.44200,55430
2143,LanusseMorais,1,0.00180,50133,90.44380,55430
2144,lapwingcloud,1,0.00180,50134,90.44561,55430
2145,larsgmu,1,0.00180,50135,90.44741,55430
2146,laryssasre,1,0.00180,50136,90.44922,55430
2147,LaurentLesle,1,0.00180,50137,90.45102,55430
2148,lavjoshi,1,0.00180,50138,90.45282,55430
2149,lazypolymath,1,0.00180,50139,90.45463,55430
2150,lbajolet-hashicorp,1,0.00180,50140,90.45643,55430
2151,lcssanches,1,0.00180,50141,90.45824,55430
2152,Lddeiva,1,0.00180,50142,90.46004,55430
2153,leanrobot,1,0.00180,50143,90.46184,55430
2154,lebenitza,1,0.00180,50144,90.46365,55430
2155,leernd007,1,0.00180,50145,90.46545,55430
2156,leo-alvarenga,1,0.00180,50146,90.46726,55430
2157,LeonKolyang,1,0.00180,50147,90.46906,55430
2158,levalves,1,0.00180,50148,90.47086,55430
2159,lewinkedrs,1,0.00180,50149,90.47267,55430
2160,lewinski,1,0.00180,50150,90.47447,55430
2161,lexton,1,0.00180,50151,90.47628,55430
2162,lgallard,1,0.00180,50152,90.47808,55430
2163,lhull-exzeo,1,0.00180,50153,90.47988,55430
2164,liam-witterick,1,0.00180,50154,90.48169,55430
2165,likeadeckofcards,1,0.00180,50155,90.48349,55430
2166,liljoon,1,0.00180,50156,90.48530,55430
2167,liranfarage89,1,0.00180,50157,90.48710,55430
2168,llowvxe,1,0.00180,50158,90.48890,55430
2169,logan-bobo,1,0.00180,50159,90.49071,55430
2170,LogansUA,1,0.00180,50160,90.49251,55430
2171,loivis,1,0.00180,50161,90.49432,55430
2172,loopold,1,0.00180,50162,90.49612,55430
2173,lopf,1,0.00180,50163,90.49793,55430
2174,Lorentiii,1,0.00180,50164,90.49973,55430
2175,lorenzoc25,1,0.00180,50165,90.50153,55430
2176,lorodoes,1,0.00180,50166,90.50334,55430
2177,loysosan,1,0.00180,50167,90.50514,55430
2178,lucapisciotta,1,0.00180,50168,90.50695,55430
2179,Lucasjuv,1,0.00180,50169,90.50875,55430
2180,luchees,1,0.00180,50170,90.51055,55430
2181,Lucienest,1,0.00180,50171,90.51236,55430
2182,luckydev,1,0.00180,50172,90.51416,55430
2183,luedigernet,1,0.00180,50173,90.51597,55430
2184,LukasdeBoer,1,0.00180,50174,90.51777,55430
2185,lukiffer,1,0.00180,50175,90.51957,55430
2186,luqmanMohammed,1,0.00180,50176,90.52138,55430
2187,luyao,1,0.00180,50177,90.52318,55430
2188,lvkins,1,0.00180,50178,90.52499,55430
2189,lwijesur,1,0.00180,50179,90.52679,55430
2190,M4t7e,1,0.00180,50180,90.52859,55430
2191,m7modsaer,1,0.00180,50181,90.53040,55430
2192,macros64,1,0.00180,50182,90.53220,55430
2193,madchap,1,0.00180,50183,90.53401,55430
2194,madhavvishnubhatta,1,0.00180,50184,90.53581,55430
2195,madipietro,1,0.00180,50185,90.53762,55430
2196,madKrypton,1,0.00180,50186,90.53942,55430
2197,madnight,1,0.00180,50187,90.54122,55430
2198,madpipeline,1,0.00180,50188,90.54303,55430
2199,madwizard,1,0.00180,50189,90.54483,55430
2200,MagnusChase03,1,0.00180,50190,90.54664,55430
2201,mahauber,1,0.00180,50191,90.54844,55430
2202,maheshrijal,1,0.00180,50192,90.55024,55430
2203,mahsoud,1,0.00180,50193,90.55205,55430
2204,majdi-d,1,0.00180,50194,90.55385,55430
2205,makotonakai,1,0.00180,50195,90.55566,55430
2206,manueltarouca,1,0.00180,50196,90.55746,55430
2207,maonat,1,0.00180,50197,90.55926,55430
2208,marcboudreau,1,0.00180,50198,90.56107,55430
2209,marcelmeulemans,1,0.00180,50199,90.56287,55430
2210,MarceloFCandido,1,0.00180,50200,90.56468,55430
2211,marcfrederick,1,0.00180,50201,90.56648,55430
2212,marcie001,1,0.00180,50202,90.56828,55430
2213,marcnnn,1,0.00180,50203,90.57009,55430
2214,MarcosDanielTorres,1,0.00180,50204,90.57189,55430
2215,marcosjrvrael,1,0.00180,50205,90.57370,55430
2216,marevers,1,0.00180,50206,90.57550,55430
2217,mariano-daniel,1,0.00180,50207,90.57730,55430
2218,MarianoRD,1,0.00180,50208,90.57911,55430
2219,marioasabella,1,0.00180,50209,90.58091,55430
2220,mariusmanea-selfridges,1,0.00180,50210,90.58272,55430
2221,MarkAtwood,1,0.00180,50211,90.58452,55430
2222,MarkCBell,1,0.00180,50212,90.58633,55430
2223,markoeremija,1,0.00180,50213,90.58813,55430
2224,marko-jankovic,1,0.00180,50214,90.58993,55430
2225,marksisson,1,0.00180,50215,90.59174,55430
2226,mark-the-butler,1,0.00180,50216,90.59354,55430
2227,marriva,1,0.00180,50217,90.59535,55430
2228,martinkellyde,1,0.00180,50218,90.59715,55430
2229,martin-magakian,1,0.00180,50219,90.59895,55430
2230,MartinoMensio,1,0.00180,50220,90.60076,55430
2231,martinrw,1,0.00180,50221,90.60256,55430
2232,marverix,1,0.00180,50222,90.60437,55430
2233,mateusclira,1,0.00180,50223,90.60617,55430
2234,matheusbona,1,0.00180,50224,90.60797,55430
2235,matheusmonte,1,0.00180,50225,90.60978,55430
2236,matihost,1,0.00180,50226,90.61158,55430
2237,mattcharlton,1,0.00180,50227,90.61339,55430
2238,Matthew-Beckett,1,0.00180,50228,90.61519,55430
2239,MatthewMucker,1,0.00180,50229,90.61699,55430
2240,MattJeanes,1,0.00180,50230,90.61880,55430
2241,matt-mercer,1,0.00180,50231,90.62060,55430
2242,mattsoftware,1,0.00180,50232,90.62241,55430
2243,mattyboy84,1,0.00180,50233,90.62421,55430
2244,maulerjan,1,0.00180,50234,90.62601,55430
2245,maxadamo,1,0.00180,50235,90.62782,55430
2246,maxcleme,1,0.00180,50236,90.62962,55430
2247,maxfielb,1,0.00180,50237,90.63143,55430
2248,maxkratz,1,0.00180,50238,90.63323,55430
2249,max-ts0gt,1,0.00180,50239,90.63504,55430
2250,maxvt-tonal,1,0.00180,50240,90.63684,55430
2251,mayne75,1,0.00180,50241,90.63864,55430
2252,mayurkr,1,0.00180,50242,90.64045,55430
2253,MB175,1,0.00180,50243,90.64225,55430
2254,mbelchev,1,0.00180,50244,90.64406,55430
2255,mbenabda,1,0.00180,50245,90.64586,55430
2256,mbrightcpacket,1,0.00180,50246,90.64766,55430
2257,mccoyer001,1,0.00180,50247,90.64947,55430
2258,mcdm-mx,1,0.00180,50248,90.65127,55430
2259,McGon-Fid,1,0.00180,50249,90.65308,55430
2260,mcgrof,1,0.00180,50250,90.65488,55430
2261,mcleanbc,1,0.00180,50251,90.65668,55430
2262,mcncl,1,0.00180,50252,90.65849,55430
2263,mdaeunlee,1,0.00180,50253,90.66029,55430
2264,mdaleo404,1,0.00180,50254,90.66210,55430
2265,mdsanima,1,0.00180,50255,90.66390,55430
2266,mednbiba,1,0.00180,50256,90.66570,55430
2267,MegaportPhilipBrowne,1,0.00180,50257,90.66751,55430
2268,megashby,1,0.00180,50258,90.66931,55430
2269,mehdi-aws,1,0.00180,50259,90.67112,55430
2270,meixnerlu,1,0.00180,50260,90.67292,55430
2271,mergenci,1,0.00180,50261,90.67472,55430
2272,Mertronics,1,0.00180,50262,90.67653,55430
2273,meswapnilk,1,0.00180,50263,90.67833,55430
2274,metalim,1,0.00180,50264,90.68014,55430
2275,metalingusman,1,0.00180,50265,90.68194,55430
2276,mgirouard,1,0.00180,50266,90.68375,55430
2277,mhh611,1,0.00180,50267,90.68555,55430
2278,MichaelAicher,1,0.00180,50268,90.68735,55430
2279,michaelbrewer,1,0.00180,50269,90.68916,55430
2280,michaeljneely,1,0.00180,50270,90.69096,55430
2281,michaeljohn32,1,0.00180,50271,90.69277,55430
2282,Michagogo,1,0.00180,50272,90.69457,55430
2283,Microsomes,1,0.00180,50273,90.69637,55430
2284,mig4ng,1,0.00180,50274,90.69818,55430
2285,miguelzenteno,1,0.00180,50275,90.69998,55430
2286,mihajlovics,1,0.00180,50276,90.70179,55430
2287,mihretkidane-OCI,1,0.00180,50277,90.70359,55430
2288,mikebobadilla,1,0.00180,50278,90.70539,55430
2289,mikecarr2,1,0.00180,50279,90.70720,55430
2290,mikeflinn,1,0.00180,50280,90.70900,55430
2291,MikeKlebolt,1,0.00180,50281,90.71081,55430
2292,mikelina,1,0.00180,50282,90.71261,55430
2293,MikeMcQuaid,1,0.00180,50283,90.71441,55430
2294,mikhail-zhadanov,1,0.00180,50284,90.71622,55430
2295,mikolajzajac,1,0.00180,50285,90.71802,55430
2296,mikzuit,1,0.00180,50286,90.71983,55430
2297,miles-qarik,1,0.00180,50287,90.72163,55430
2298,miltlima,1,0.00180,50288,90.72343,55430
2299,minecraftchest1,1,0.00180,50289,90.72524,55430
2300,mirzaeiyan,1,0.00180,50290,90.72704,55430
2301,miutamihai,1,0.00180,50291,90.72885,55430
2302,mixollm94,1,0.00180,50292,90.73065,55430
2303,mju,1,0.00180,50293,90.73246,55430
2304,mkemmerz,1,0.00180,50294,90.73426,55430
2305,mkesper,1,0.00180,50295,90.73606,55430
2306,mkhtse,1,0.00180,50296,90.73787,55430
2307,MKK711,1,0.00180,50297,90.73967,55430
2308,mklarsen,1,0.00180,50298,90.74148,55430
2309,mklauber,1,0.00180,50299,90.74328,55430
2310,mkohn,1,0.00180,50300,90.74508,55430
2311,mmigliari,1,0.00180,50301,90.74689,55430
2312,MMollyy,1,0.00180,50302,90.74869,55430
2313,MMShep97,1,0.00180,50303,90.75050,55430
2314,MMS-RBKN,1,0.00180,50304,90.75230,55430
2315,mmwilbert,1,0.00180,50305,90.75410,55430
2316,moabu,1,0.00180,50306,90.75591,55430
2317,moccoh,1,0.00180,50307,90.75771,55430
2318,Mohammad-AlRousan,1,0.00180,50308,90.75952,55430
2319,Mohammed-5253,1,0.00180,50309,90.76132,55430
2320,monteiro-renato,1,0.00180,50310,90.76312,55430
2321,moseskt,1,0.00180,50311,90.76493,55430
2322,mouhannad-sh,1,0.00180,50312,90.76673,55430
2323,mousedownmike,1,0.00180,50313,90.76854,55430
2324,MrAlex475,1,0.00180,50314,90.77034,55430
2325,MrDaGree,1,0.00180,50315,90.77215,55430
2326,mrdumpty,1,0.00180,50316,90.77395,55430
2327,mrjones-plip,1,0.00180,50317,90.77575,55430
2328,mrkesu,1,0.00180,50318,90.77756,55430
2329,mrsaiz,1,0.00180,50319,90.77936,55430
2330,mrsheepuk,1,0.00180,50320,90.78117,55430
2331,msfidelis,1,0.00180,50321,90.78297,55430
2332,mstiri,1,0.00180,50322,90.78477,55430
2333,mtslzr,1,0.00180,50323,90.78658,55430
2334,muellert,1,0.00180,50324,90.78838,55430
2335,mungojam,1,0.00180,50325,90.79019,55430
2336,munnep,1,0.00180,50326,90.79199,55430
2337,murali-partha,1,0.00180,50327,90.79379,55430
2338,mvandenburgh,1,0.00180,50328,90.79560,55430
2339,mwalser,1,0.00180,50329,90.79740,55430
2340,MXfive,1,0.00180,50330,90.79921,55430
2341,mxshooter,1,0.00180,50331,90.80101,55430
2342,MykKuc,1,0.00180,50332,90.80281,55430
2343,My-Random-Thoughts,1,0.00180,50333,90.80462,55430
2344,mysticrenji,1,0.00180,50334,90.80642,55430
2345,nadhirxz,1,0.00180,50335,90.80823,55430
2346,Nadine-Raiss-Wakam,1,0.00180,50336,90.81003,55430
2347,nagyist,1,0.00180,50337,90.81183,55430
2348,nammotd,1,0.00180,50338,90.81364,55430
2349,naorpeled,1,0.00180,50339,90.81544,55430
2350,nate-selzer,1,0.00180,50340,90.81725,55430
2351,NathanFlurry,1,0.00180,50341,90.81905,55430
2352,nathan-mittelette,1,0.00180,50342,90.82086,55430
2353,NathStevo97,1,0.00180,50343,90.82266,55430
2354,Nayankumar696583,1,0.00180,50344,90.82446,55430
2355,nazimisik,1,0.00180,50345,90.82627,55430
2356,ndonathan,1,0.00180,50346,90.82807,55430
2357,ndouglas,1,0.00180,50347,90.82988,55430
2358,nduyphuong,1,0.00180,50348,90.83168,55430
2359,NefixEstrada,1,0.00180,50349,90.83348,55430
2360,neo-diego-nunes,1,0.00180,50350,90.83529,55430
2361,nesty92,1,0.00180,50351,90.83709,55430
2362,Netkracker,1,0.00180,50352,90.83890,55430
2363,NetMoose,1,0.00180,50353,90.84070,55430
2364,netoax,1,0.00180,50354,90.84250,55430
2365,netologist,1,0.00180,50355,90.84431,55430
2366,nextdarius,1,0.00180,50356,90.84611,55430
2367,NFollett89,1,0.00180,50357,90.84792,55430
2368,ngeorger,1,0.00180,50358,90.84972,55430
2369,ngharo,1,0.00180,50359,90.85152,55430
2370,ngoyal16,1,0.00180,50360,90.85333,55430
2371,n-h-n,1,0.00180,50361,90.85513,55430
2372,NickCellino,1,0.00180,50362,90.85694,55430
2373,nickdelnano,1,0.00180,50363,90.85874,55430
2374,nickel-tyler,1,0.00180,50364,90.86054,55430
2375,nickkatsios,1,0.00180,50365,90.86235,55430
2376,nickpodobiedov,1,0.00180,50366,90.86415,55430
2377,nicksia-vgw,1,0.00180,50367,90.86596,55430
2378,NicksonT,1,0.00180,50368,90.86776,55430
2379,NickSpaghetti,1,0.00180,50369,90.86957,55430
2380,nick-williams-spirit,1,0.00180,50370,90.87137,55430
2381,nico01f,1,0.00180,50371,90.87317,55430
2382,NicoFgrx,1,0.00180,50372,90.87498,55430
2383,nicolaschambrier,1,0.00180,50373,90.87678,55430
2384,NicoleYarbrough,1,0.00180,50374,90.87859,55430
2385,nicoluca,1,0.00180,50375,90.88039,55430
2386,nicosingh,1,0.00180,50376,90.88219,55430
2387,nielsbaltodanomatrix,1,0.00180,50377,90.88400,55430
2388,nikaro,1,0.00180,50378,90.88580,55430
2389,nikhil-pandey,1,0.00180,50379,90.88761,55430
2390,nikolai-fra,1,0.00180,50380,90.88941,55430
2391,nikoshet,1,0.00180,50381,90.89121,55430
2392,NilsBusche,1,0.00180,50382,90.89302,55430
2393,nimboya,1,0.00180,50383,90.89482,55430
2394,ningen1,1,0.00180,50384,90.89663,55430
2395,nkotov,1,0.00180,50385,90.89843,55430
2396,nlucansk,1,0.00180,50386,90.90023,55430
2397,nmanoogian,1,0.00180,50387,90.90204,55430
2398,nneul,1,0.00180,50388,90.90384,55430
2399,nnovikov,1,0.00180,50389,90.90565,55430
2400,noamcohen97,1,0.00180,50390,90.90745,55430
2401,Noamstrauss,1,0.00180,50391,90.90925,55430
2402,NoelJacob,1,0.00180,50392,90.91106,55430
2403,noel-phelt,1,0.00180,50393,90.91286,55430
2404,nohant,1,0.00180,50394,90.91467,55430
2405,nomeelnoj,1,0.00180,50395,90.91647,55430
2406,norman-zon,1,0.00180,50396,90.91828,55430
2407,norrland,1,0.00180,50397,90.92008,55430
2408,NotM32,1,0.00180,50398,90.92188,55430
2409,np5,1,0.00180,50399,90.92369,55430
2410,npezzotti,1,0.00180,50400,90.92549,55430
2411,nphilbrook,1,0.00180,50401,90.92730,55430
2412,npk-amperon,1,0.00180,50402,90.92910,55430
2413,nr-hmerac,1,0.00180,50403,90.93090,55430
2414,nrv-96,1,0.00180,50404,90.93271,55430
2415,NSSPKrishna,1,0.00180,50405,90.93451,55430
2416,nwsparks,1,0.00180,50406,90.93632,55430
2417,nylo-andry,1,0.00180,50407,90.93812,55430
2418,nywilken,1,0.00180,50408,90.93992,55430
2419,o1da,1,0.00180,50409,90.94173,55430
2420,oanhnn,1,0.00180,50410,90.94353,55430
2421,obataku,1,0.00180,50411,90.94534,55430
2422,Octogonapus,1,0.00180,50412,90.94714,55430
2423,odinsy,1,0.00180,50413,90.94894,55430
2424,oferchen,1,0.00180,50414,90.95075,55430
2425,olaaun,1,0.00180,50415,90.95255,55430
2426,oleksiimorozenko,1,0.00180,50416,90.95436,55430
2427,oleksiy-pototskyy,1,0.00180,50417,90.95616,55430
2428,oliverjfletcher,1,0.00180,50418,90.95797,55430
2429,oliverwelter,1,0.00180,50419,90.95977,55430
2430,Olliepop,1,0.00180,50420,90.96157,55430
2431,ollyjshaw,1,0.00180,50421,90.96338,55430
2432,omairz1,1,0.00180,50422,90.96518,55430
2433,omegazyadav,1,0.00180,50423,90.96699,55430
2434,OmkarKirpan,1,0.00180,50424,90.96879,55430
2435,omnibrian,1,0.00180,50425,90.97059,55430
2436,onthatass-coder,1,0.00180,50426,90.97240,55430
2437,opeyemitechpro,1,0.00180,50427,90.97420,55430
2438,ops-gaurav,1,0.00180,50428,90.97601,55430
2439,orbang,1,0.00180,50429,90.97781,55430
2440,orgads,1,0.00180,50430,90.97961,55430
2441,orky-dev,1,0.00180,50431,90.98142,55430
2442,ottramst,1,0.00180,50432,90.98322,55430
2443,owlot,1,0.00180,50433,90.98503,55430
2444,oycyc,1,0.00180,50434,90.98683,55430
2445,p2sk-ann,1,0.00180,50435,90.98863,55430
2446,pab1it0,1,0.00180,50436,90.99044,55430
2447,Pablo-Oliveira,1,0.00180,50437,90.99224,55430
2448,PandaShad,1,0.00180,50438,90.99405,55430
2449,pangteypiyush,1,0.00180,50439,90.99585,55430
2450,pankajsa,1,0.00180,50440,90.99765,55430
2451,pasdam,1,0.00180,50441,90.99946,55430
2452,pasettifabio,1,0.00180,50442,91.00126,55430
2453,pataquets,1,0.00180,50443,91.00307,55430
2454,pathak1515,1,0.00180,50444,91.00487,55430
2455,PatMyron,1,0.00180,50445,91.00668,55430
2456,patrick-andrew-jain-taylor,1,0.00180,50446,91.00848,55430
2457,patrickcping,1,0.00180,50447,91.01028,55430
2458,patrickdung,1,0.00180,50448,91.01209,55430
2459,patters-match,1,0.00180,50449,91.01389,55430
2460,paulanunda,1,0.00180,50450,91.01570,55430
2461,PaulaPaul,1,0.00180,50451,91.01750,55430
2462,paul-civitas,1,0.00180,50452,91.01930,55430
2463,pavedroad,1,0.00180,50453,91.02111,55430
2464,pavellad,1,0.00180,50454,91.02291,55430
2465,pavelzw,1,0.00180,50455,91.02472,55430
2466,pedrokiefer,1,0.00180,50456,91.02652,55430
2467,Peet-HD,1,0.00180,50457,91.02832,55430
2468,pemcne,1,0.00180,50458,91.03013,55430
2469,pen-pal,1,0.00180,50459,91.03193,55430
2470,perjahn,1,0.00180,50460,91.03374,55430
2471,peter-volkov,1,0.00180,50461,91.03554,55430
2472,PetrHeinz,1,0.00180,50462,91.03734,55430
2473,petr-stupka,1,0.00180,50463,91.03915,55430
2474,petrzvolanek,1,0.00180,50464,91.04095,55430
2475,ph0uad,1,0.00180,50465,91.04276,55430
2476,ph4r5h4d,1,0.00180,50466,91.04456,55430
2477,Phadin,1,0.00180,50467,91.04636,55430
2478,phenixcoder,1,0.00180,50468,91.04817,55430
2479,phergoualch,1,0.00180,50469,91.04997,55430
2480,PhilippSeitz,1,0.00180,50470,91.05178,55430
2481,Phil-Thoennissen,1,0.00180,50471,91.05358,55430
2482,phormio,1,0.00180,50472,91.05539,55430
2483,phsmith,1,0.00180,50473,91.05719,55430
2484,phuhung273,1,0.00180,50474,91.05899,55430
2485,phunyguy,1,0.00180,50475,91.06080,55430
2486,pierolenzo,1,0.00180,50476,91.06260,55430
2487,PierreM-gh,1,0.00180,50477,91.06441,55430
2488,pietdaniel,1,0.00180,50478,91.06621,55430
2489,Pikaro,1,0.00180,50479,91.06801,55430
2490,PincessWoona,1,0.00180,50480,91.06982,55430
2491,piotrplenik,1,0.00180,50481,91.07162,55430
2492,pivotal-marcela-campo,1,0.00180,50482,91.07343,55430
2493,pixelblob,1,0.00180,50483,91.07523,55430
2494,pixelfields,1,0.00180,50484,91.07703,55430
2495,pixie79,1,0.00180,50485,91.07884,55430
2496,Piyaphong,1,0.00180,50486,91.08064,55430
2497,pizzamon,1,0.00180,50487,91.08245,55430
2498,pmbauer,1,0.00180,50488,91.08425,55430
2499,pmmukh,1,0.00180,50489,91.08605,55430
2500,pmossakx,1,0.00180,50490,91.08786,55430
2501,polski-g,1,0.00180,50491,91.08966,55430
2502,ponkio-o,1,0.00180,50492,91.09147,55430
2503,Poorvasharma25,1,0.00180,50493,91.09327,55430
2504,poshett,1,0.00180,50494,91.09507,55430
2505,PowerShellJC,1,0.00180,50495,91.09688,55430
2506,PPACI,1,0.00180,50496,91.09868,55430
2507,PP-Namias,1,0.00180,50497,91.10049,55430
2508,pr0way,1,0.00180,50498,91.10229,55430
2509,prabhavpawar,1,0.00180,50499,91.10410,55430
2510,pratik268,1,0.00180,50500,91.10590,55430
2511,praveen-tiwari-iopshub,1,0.00180,50501,91.10770,55430
2512,pregress,1,0.00180,50502,91.10951,55430
2513,prestonprice57,1,0.00180,50503,91.11131,55430
2514,prince310501,1,0.00180,50504,91.11312,55430
2515,priom,1,0.00180,50505,91.11492,55430
2516,prithvi514,1,0.00180,50506,91.11672,55430
2517,PriyanshNegi,1,0.00180,50507,91.11853,55430
2518,professional-ian,1,0.00180,50508,91.12033,55430
2519,promiseibe,1,0.00180,50509,91.12214,55430
2520,pryschepa,1,0.00180,50510,91.12394,55430
2521,PseudoCoding,1,0.00180,50511,91.12574,55430
2522,psrebniak,1,0.00180,50512,91.12755,55430
2523,pureiboi,1,0.00180,50513,91.12935,55430
2524,pwrsoft,1,0.00180,50514,91.13116,55430
2525,q8webmaster,1,0.00180,50515,91.13296,55430
2526,qetza,1,0.00180,50516,91.13476,55430
2527,QJoly,1,0.00180,50517,91.13657,55430
2528,qqii,1,0.00180,50518,91.13837,55430
2529,raditzfarhan,1,0.00180,50519,91.14018,55430
2530,radius314,1,0.00180,50520,91.14198,55430
2531,rafcruz,1,0.00180,50521,91.14378,55430
2532,rafsaf,1,0.00180,50522,91.14559,55430
2533,ragincajunbanjo,1,0.00180,50523,91.14739,55430
2534,rama280290,1,0.00180,50524,91.14920,55430
2535,ramaureirac,1,0.00180,50525,91.15100,55430
2536,ramondomiingos,1,0.00180,50526,91.15281,55430
2537,ramonvermeulen,1,0.00180,50527,91.15461,55430
2538,RanveerMeel,1,0.00180,50528,91.15641,55430
2539,raphaelcardoso,1,0.00180,50529,91.15822,55430
2540,ravager-dk,1,0.00180,50530,91.16002,55430
2541,ravibhure,1,0.00180,50531,91.16183,55430
2542,RaviRanjan02,1,0.00180,50532,91.16363,55430
2543,ravishtiwari,1,0.00180,50533,91.16543,55430
2544,ravron,1,0.00180,50534,91.16724,55430
2545,rawis,1,0.00180,50535,91.16904,55430
2546,Raymond-Ly,1,0.00180,50536,91.17085,55430
2547,RazvanBerbece,1,0.00180,50537,91.17265,55430
2548,rbange,1,0.00180,50538,91.17445,55430
2549,rbreslow,1,0.00180,50539,91.17626,55430
2550,rclilly,1,0.00180,50540,91.17806,55430
2551,rdash99,1,0.00180,50541,91.17987,55430
2552,rdtechie,1,0.00180,50542,91.18167,55430
2553,realexcel2021,1,0.00180,50543,91.18347,55430
2554,realsby,1,0.00180,50544,91.18528,55430
2555,reastyn,1,0.00180,50545,91.18708,55430
2556,reesericci,1,0.00180,50546,91.18889,55430
2557,reflection,1,0.00180,50547,91.19069,55430
2558,rehos,1,0.00180,50548,91.19250,55430
2559,RemyJrd,1,0.00180,50549,91.19430,55430
2560,rericsson,1,0.00180,50550,91.19610,55430
2561,reskin89,1,0.00180,50551,91.19791,55430
2562,reubenjds,1,0.00180,50552,91.19971,55430
2563,rfhold,1,0.00180,50553,91.20152,55430
2564,rflament,1,0.00180,50554,91.20332,55430
2565,rgarrigue,1,0.00180,50555,91.20512,55430
2566,rhernaus,1,0.00180,50556,91.20693,55430
2567,rhowe,1,0.00180,50557,91.20873,55430
2568,rhys57h,1,0.00180,50558,91.21054,55430
2569,Rhys-CS,1,0.00180,50559,91.21234,55430
2570,RicePatrick,1,0.00180,50560,91.21414,55430
2571,richardr35,1,0.00180,50561,91.21595,55430
2572,richsage,1,0.00180,50562,91.21775,55430
2573,Rick-van-Dam,1,0.00180,50563,91.21956,55430
2574,rinzool,1,0.00180,50564,91.22136,55430
2575,risadams,1,0.00180,50565,91.22316,55430
2576,rithik56,1,0.00180,50566,91.22497,55430
2577,rjamestaylor,1,0.00180,50567,91.22677,55430
2578,rjw1,1,0.00180,50568,91.22858,55430
2579,rkeegan,1,0.00180,50569,91.23038,55430
2580,rl-abdulkarim,1,0.00180,50570,91.23218,55430
2581,rlewis-grax,1,0.00180,50571,91.23399,55430
2582,rlmckenney,1,0.00180,50572,91.23579,55430
2583,rneiva,1,0.00180,50573,91.23760,55430
2584,roachmd,1,0.00180,50574,91.23940,55430
2585,robbytaylor,1,0.00180,50575,91.24121,55430
2586,robdewit,1,0.00180,50576,91.24301,55430
2587,robertbrandso,1,0.00180,50577,91.24481,55430
2588,robertgv,1,0.00180,50578,91.24662,55430
2589,roberthlombardi,1,0.00180,50579,91.24842,55430
2590,robert-nemet,1,0.00180,50580,91.25023,55430
2591,RobinSpanier,1,0.00180,50581,91.25203,55430
2592,robmoss2k,1,0.00180,50582,91.25383,55430
2593,RobStolte,1,0.00180,50583,91.25564,55430
2594,rockdrilla,1,0.00180,50584,91.25744,55430
2595,RockyMM,1,0.00180,50585,91.25925,55430
2596,rodrigo-hcp,1,0.00180,50586,91.26105,55430
2597,rodrigost23,1,0.00180,50587,91.26285,55430
2598,rogerdipasquale,1,0.00180,50588,91.26466,55430
2599,romsrb,1,0.00180,50589,91.26646,55430
2600,rondemena,1,0.00180,50590,91.26827,55430
2601,ronenniv,1,0.00180,50591,91.27007,55430
2602,RonSijm,1,0.00180,50592,91.27187,55430
2603,rory-hughes-cko,1,0.00180,50593,91.27368,55430
2604,RossMMason,1,0.00180,50594,91.27548,55430
2605,RostakTom,1,0.00180,50595,91.27729,55430
2606,rost-d,1,0.00180,50596,91.27909,55430
2607,rottenbytes,1,0.00180,50597,91.28089,55430
2608,rowaasr13,1,0.00180,50598,91.28270,55430
2609,Roymprog,1,0.00180,50599,91.28450,55430
2610,rsarkar29,1,0.00180,50600,91.28631,55430
2611,rsegers,1,0.00180,50601,91.28811,55430
2612,rshade,1,0.00180,50602,91.28992,55430
2613,rtfee,1,0.00180,50603,91.29172,55430
2614,rtizzy,1,0.00180,50604,91.29352,55430
2615,rubenelshof,1,0.00180,50605,91.29533,55430
2616,RubenSemiao,1,0.00180,50606,91.29713,55430
2617,rudimk,1,0.00180,50607,91.29894,55430
2618,Ruibin-Liu,1,0.00180,50608,91.30074,55430
2619,russd2357,1,0.00180,50609,91.30254,55430
2620,russellhancox,1,0.00180,50610,91.30435,55430
2621,rvandenbedem,1,0.00180,50611,91.30615,55430
2622,rvoh-tismith,1,0.00180,50612,91.30796,55430
2623,ryacaliso001,1,0.00180,50613,91.30976,55430
2624,RyanBijkerk,1,0.00180,50614,91.31156,55430
2625,ryanhs,1,0.00180,50615,91.31337,55430
2626,RYOSKATE,1,0.00180,50616,91.31517,55430
2627,rzfeeser,1,0.00180,50617,91.31698,55430
2628,sabazubair,1,0.00180,50618,91.31878,55430
2629,SadmL,1,0.00180,50619,91.32058,55430
2630,safonas,1,0.00180,50620,91.32239,55430
2631,sagitsofan,1,0.00180,50621,91.32419,55430
2632,Sagoito,1,0.00180,50622,91.32600,55430
2633,sahnikan,1,0.00180,50623,91.32780,55430
2634,saif-02,1,0.00180,50624,91.32960,55430
2635,sakazuki,1,0.00180,50625,91.33141,55430
2636,salmanamjad28,1,0.00180,50626,91.33321,55430
2637,samcook,1,0.00180,50627,91.33502,55430
2638,SametKUM,1,0.00180,50628,91.33682,55430
2639,samraola30,1,0.00180,50629,91.33863,55430
2640,SamuelDoud,1,0.00180,50630,91.34043,55430
2641,samueltan3972,1,0.00180,50631,91.34223,55430
2642,sandeepckumar,1,0.00180,50632,91.34404,55430
2643,sandrom,1,0.00180,50633,91.34584,55430
2644,sandytoshev,1,0.00180,50634,91.34765,55430
2645,sanjaypsachdev,1,0.00180,50635,91.34945,55430
2646,sapher,1,0.00180,50636,91.35125,55430
2647,sapslaj,1,0.00180,50637,91.35306,55430
2648,sarveshkanwar,1,0.00180,50638,91.35486,55430
2649,sashasimkin,1,0.00180,50639,91.35667,55430
2650,satoru-hata,1,0.00180,50640,91.35847,55430
2651,Saulimedes,1,0.00180,50641,91.36027,55430
2652,sauravpanda,1,0.00180,50642,91.36208,55430
2653,saurbhc,1,0.00180,50643,91.36388,55430
2654,savar,1,0.00180,50644,91.36569,55430
2655,sbernier-corp,1,0.00180,50645,91.36749,55430
2656,sbldevnet,1,0.00180,50646,91.36929,55430
2657,sbokhari-itex,1,0.00180,50647,91.37110,55430
2658,sbutler,1,0.00180,50648,91.37290,55430
2659,Schbatzafresser,1,0.00180,50649,91.37471,55430
2660,schdief,1,0.00180,50650,91.37651,55430
2661,schrodervictor,1,0.00180,50651,91.37831,55430
2662,schue,1,0.00180,50652,91.38012,55430
2663,ScottBrenner,1,0.00180,50653,91.38192,55430
2664,scottseelyinc,1,0.00180,50654,91.38373,55430
2665,scott-the-programmer,1,0.00180,50655,91.38553,55430
2666,scratchifoo,1,0.00180,50656,91.38734,55430
2667,scurow,1,0.00180,50657,91.38914,55430
2668,sean-nixon,1,0.00180,50658,91.39094,55430
2669,seanseth7,1,0.00180,50659,91.39275,55430
2670,sebandgo,1,0.00180,50660,91.39455,55430
2671,SebastianSlaby,1,0.00180,50661,91.39636,55430
2672,SebastjanPrachovskij,1,0.00180,50662,91.39816,55430
2673,sebs,1,0.00180,50663,91.39996,55430
2674,second-constantine,1,0.00180,50664,91.40177,55430
2675,seiyab,1,0.00180,50665,91.40357,55430
2676,sekhar5031,1,0.00180,50666,91.40538,55430
2677,SekhReddy,1,0.00180,50667,91.40718,55430
2678,sellisd,1,0.00180,50668,91.40898,55430
2679,senare,1,0.00180,50669,91.41079,55430
2680,SeptBlast,1,0.00180,50670,91.41259,55430
2681,serpro69,1,0.00180,50671,91.41440,55430
2682,seveas,1,0.00180,50672,91.41620,55430
2683,Sevgintrampov,1,0.00180,50673,91.41800,55430
2684,sgorshkov85,1,0.00180,50674,91.41981,55430
2685,shadodan,1,0.00180,50675,91.42161,55430
2686,sharaexcel,1,0.00180,50676,91.42342,55430
2687,shaw1337,1,0.00180,50677,91.42522,55430
2688,shawnaws,1,0.00180,50678,91.42703,55430
2689,Sheludchenko,1,0.00180,50679,91.42883,55430
2690,shencan,1,0.00180,50680,91.43063,55430
2691,shimonelbaz,1,0.00180,50681,91.43244,55430
2692,shin-san,1,0.00180,50682,91.43424,55430
2693,shivalisharma23,1,0.00180,50683,91.43605,55430
2694,Shi-vasana,1,0.00180,50684,91.43785,55430
2695,shlomimatichin,1,0.00180,50685,91.43965,55430
2696,shmokmt,1,0.00180,50686,91.44146,55430
2697,showwin,1,0.00180,50687,91.44326,55430
2698,shwejanraj,1,0.00180,50688,91.44507,55430
2699,shyamalkirpan,1,0.00180,50689,91.44687,55430
2700,ShyAssassin,1,0.00180,50690,91.44867,55430
2701,sidneiweber,1,0.00180,50691,91.45048,55430
2702,siennathesane,1,0.00180,50692,91.45228,55430
2703,SierraJC,1,0.00180,50693,91.45409,55430
2704,SignalWhisperer,1,0.00180,50694,91.45589,55430
2705,Sigura,1,0.00180,50695,91.45769,55430
2706,simaotwx,1,0.00180,50696,91.45950,55430
2707,simonjohansson,1,0.00180,50697,91.46130,55430
2708,simonoff,1,0.00180,50698,91.46311,55430
2709,simonxmh,1,0.00180,50699,91.46491,55430
2710,sircthulhu,1,0.00180,50700,91.46671,55430
2711,sir-david,1,0.00180,50701,91.46852,55430
2712,SirPatrykKawa,1,0.00180,50702,91.47032,55430
2713,sivajayaraman,1,0.00180,50703,91.47213,55430
2714,SizZiKe,1,0.00180,50704,91.47393,55430
2715,sjaghori,1,0.00180,50705,91.47574,55430
2716,sjbokhari,1,0.00180,50706,91.47754,55430
2717,sknopp,1,0.00180,50707,91.47934,55430
2718,skoppe,1,0.00180,50708,91.48115,55430
2719,skrivopishin,1,0.00180,50709,91.48295,55430
2720,slayer,1,0.00180,50710,91.48476,55430
2721,sleepwithcoffee,1,0.00180,50711,91.48656,55430
2722,slideroh,1,0.00180,50712,91.48836,55430
2723,sloloris,1,0.00180,50713,91.49017,55430
2724,slushysnowman,1,0.00180,50714,91.49197,55430
2725,smokedlinq,1,0.00180,50715,91.49378,55430
2726,smythluke,1,0.00180,50716,91.49558,55430
2727,Snackeroo,1,0.00180,50717,91.49738,55430
2728,socherbyc,1,0.00180,50718,91.49919,55430
2729,sodul,1,0.00180,50719,91.50099,55430
2730,soheilsheikh,1,0.00180,50720,91.50280,55430
2731,sombochea,1,0.00180,50721,91.50460,55430
2732,sonykphilip,1,0.00180,50722,91.50640,55430
2733,SourceQuality,1,0.00180,50723,91.50821,55430
2734,space124,1,0.00180,50724,91.51001,55430
2735,spacefuntus,1,0.00180,50725,91.51182,55430
2736,spangaer,1,0.00180,50726,91.51362,55430
2737,SpartakusMd,1,0.00180,50727,91.51542,55430
2738,sp-jcberleur,1,0.00180,50728,91.51723,55430
2739,Sprittoo,1,0.00180,50729,91.51903,55430
2740,sQu4rks,1,0.00180,50730,91.52084,55430
2741,srgoni,1,0.00180,50731,91.52264,55430
2742,ss49919201,1,0.00180,50732,91.52445,55430
2743,sssanjaya,1,0.00180,50733,91.52625,55430
2744,StamatisChr,1,0.00180,50734,91.52805,55430
2745,stdevel,1,0.00180,50735,91.52986,55430
2746,stefan-matic,1,0.00180,50736,91.53166,55430
2747,stefano-franco,1,0.00180,50737,91.53347,55430
2748,stephanme,1,0.00180,50738,91.53527,55430
2749,stephenlb,1,0.00180,50739,91.53707,55430
2750,Stephvan,1,0.00180,50740,91.53888,55430
2751,stergem,1,0.00180,50741,91.54068,55430
2752,stevensdavid,1,0.00180,50742,91.54249,55430
2753,stillinbeta,1,0.00180,50743,91.54429,55430
2754,strakh-alex,1,0.00180,50744,91.54609,55430
2755,subkryl,1,0.00180,50745,91.54790,55430
2756,sugar700,1,0.00180,50746,91.54970,55430
2757,sugar-cat7,1,0.00180,50747,91.55151,55430
2758,sumeetninawe,1,0.00180,50748,91.55331,55430
2759,sumit-sampang-rai,1,0.00180,50749,91.55511,55430
2760,sunch4se,1,0.00180,50750,91.55692,55430
2761,SuryanarayanaPeri,1,0.00180,50751,91.55872,55430
2762,suryaoruganti,1,0.00180,50752,91.56053,55430
2763,susiesolis,1,0.00180,50753,91.56233,55430
2764,svivekkrishna,1,0.00180,50754,91.56413,55430
2765,swupdiedoowap,1,0.00180,50755,91.56594,55430
2766,syl-aws,1,0.00180,50756,91.56774,55430
2767,Sylfwood,1,0.00180,50757,91.56955,55430
2768,sylvinus,1,0.00180,50758,91.57135,55430
2769,symplesims,1,0.00180,50759,91.57316,55430
2770,sys-av,1,0.00180,50760,91.57496,55430
2771,szubersk,1,0.00180,50761,91.57676,55430
2772,SzymkowskiDev,1,0.00180,50762,91.57857,55430
2773,t04glovern,1,0.00180,50763,91.58037,55430
2774,tabowling,1,0.00180,50764,91.58218,55430
2775,takakuni-classmethod,1,0.00180,50765,91.58398,55430
2776,TakumiHaruta,1,0.00180,50766,91.58578,55430
2777,tassilomoedl,1,0.00180,50767,91.58759,55430
2778,tatsuo48,1,0.00180,50768,91.58939,55430
2779,taufort,1,0.00180,50769,91.59120,55430
2780,taylorhg,1,0.00180,50770,91.59300,55430
2781,tbckr,1,0.00180,50771,91.59480,55430
2782,tbobm,1,0.00180,50772,91.59661,55430
2783,tbublik,1,0.00180,50773,91.59841,55430
2784,tcarreira,1,0.00180,50774,91.60022,55430
2785,tchiotludo,1,0.00180,50775,91.60202,55430
2786,tculp,1,0.00180,50776,91.60382,55430
2787,TechnicallyJoe,1,0.00180,50777,91.60563,55430
2788,tegarimansyah,1,0.00180,50778,91.60743,55430
2789,tejashwikalptaru,1,0.00180,50779,91.60924,55430
2790,tenpaiyomi,1,0.00180,50780,91.61104,55430
2791,Tenzer,1,0.00180,50781,91.61285,55430
2792,testfile2,1,0.00180,50782,91.61465,55430
2793,tete2soja,1,0.00180,50783,91.61645,55430
2794,tgoodsell-tempus,1,0.00180,50784,91.61826,55430
2795,thatderek,1,0.00180,50785,91.62006,55430
2796,thatguylah,1,0.00180,50786,91.62187,55430
2797,TheJenne18,1,0.00180,50787,91.62367,55430
2798,TheLonelyGhost,1,0.00180,50788,91.62547,55430
2799,theonlyjohnny,1,0.00180,50789,91.62728,55430
2800,TheScarletArrow,1,0.00180,50790,91.62908,55430
2801,thezeroend,1,0.00180,50791,91.63089,55430
2802,thiennguyen56,1,0.00180,50792,91.63269,55430
2803,thinkstack,1,0.00180,50793,91.63449,55430
2804,thisdougb,1,0.00180,50794,91.63630,55430
2805,thoeng-nuuday,1,0.00180,50795,91.63810,55430
2806,Thomas-Franklin,1,0.00180,50796,91.63991,55430
2807,thomas-vl,1,0.00180,50797,91.64171,55430
2808,Thomas-X,1,0.00180,50798,91.64351,55430
2809,Timboo89,1,0.00180,50799,91.64532,55430
2810,timin,1,0.00180,50800,91.64712,55430
2811,timkrins,1,0.00180,50801,91.64893,55430
2812,timothyjrogers,1,0.00180,50802,91.65073,55430
2813,timrcoulson,1,0.00180,50803,91.65253,55430
2814,tina-le7617,1,0.00180,50804,91.65434,55430
2815,tiran133,1,0.00180,50805,91.65614,55430
2816,tism,1,0.00180,50806,91.65795,55430
2817,tjololo,1,0.00180,50807,91.65975,55430
2818,tksrc,1,0.00180,50808,91.66156,55430
2819,tksx1227,1,0.00180,50809,91.66336,55430
2820,tkummer33,1,0.00180,50810,91.66516,55430
2821,tlfzhylj,1,0.00180,50811,91.66697,55430
2822,tmarlok88,1,0.00180,50812,91.66877,55430
2823,tnfsmith,1,0.00180,50813,91.67058,55430
2824,tobias-hashicorp,1,0.00180,50814,91.67238,55430
2825,tofkamp,1,0.00180,50815,91.67418,55430
2826,t-oki,1,0.00180,50816,91.67599,55430
2827,tomdavidson,1,0.00180,50817,91.67779,55430
2828,tomiito,1,0.00180,50818,91.67960,55430
2829,tomkalesse,1,0.00180,50819,91.68140,55430
2830,tommeier,1,0.00180,50820,91.68320,55430
2831,TomooAkamatsu,1,0.00180,50821,91.68501,55430
2832,tomowatt,1,0.00180,50822,91.68681,55430
2833,tomsnunes,1,0.00180,50823,91.68862,55430
2834,TomyLobo,1,0.00180,50824,91.69042,55430
2835,toni-petrina,1,0.00180,50825,91.69222,55430
2836,tovstcn,1,0.00180,50826,91.69403,55430
2837,tparvu,1,0.00180,50827,91.69583,55430
2838,tpires,1,0.00180,50828,91.69764,55430
2839,tracphil,1,0.00180,50829,91.69944,55430
2840,traien,1,0.00180,50830,91.70124,55430
2841,TravisStratton,1,0.00180,50831,91.70305,55430
2842,trek007,1,0.00180,50832,91.70485,55430
2843,trentbitterman,1,0.00180,50833,91.70666,55430
2844,tripti-gh,1,0.00180,50834,91.70846,55430
2845,trodrigues,1,0.00180,50835,91.71027,55430
2846,tropicoo,1,0.00180,50836,91.71207,55430
2847,trutled,1,0.00180,50837,91.71387,55430
2848,tsenay,1,0.00180,50838,91.71568,55430
2849,Tsimon-Dorakh,1,0.00180,50839,91.71748,55430
2850,tsunamaru,1,0.00180,50840,91.71929,55430
2851,ttahir86,1,0.00180,50841,91.72109,55430
2852,tun0,1,0.00180,50842,91.72289,55430
2853,tv-sister,1,0.00180,50843,91.72470,55430
2854,twelsh-aw,1,0.00180,50844,91.72650,55430
2855,twhateley,1,0.00180,50845,91.72831,55430
2856,TwinbrotherPro,1,0.00180,50846,91.73011,55430
2857,twosdai,1,0.00180,50847,91.73191,55430
2858,tylerfoger,1,0.00180,50848,91.73372,55430
2859,tyriis,1,0.00180,50849,91.73552,55430
2860,tzarski0,1,0.00180,50850,91.73733,55430
2861,u-blavins,1,0.00180,50851,91.73913,55430
2862,uceumice,1,0.00180,50852,91.74093,55430
2863,Udbv,1,0.00180,50853,91.74274,55430
2864,ujuc,1,0.00180,50854,91.74454,55430
2865,u-kai,1,0.00180,50855,91.74635,55430
2866,UlisesME,1,0.00180,50856,91.74815,55430
2867,ultral,1,0.00180,50857,91.74995,55430
2868,ulyssedsn,1,0.00180,50858,91.75176,55430
2869,UncleTawnos,1,0.00180,50859,91.75356,55430
2870,unStatiK,1,0.00180,50860,91.75537,55430
2871,Untersander,1,0.00180,50861,91.75717,55430
2872,uny,1,0.00180,50862,91.75898,55430
2873,uristernik,1,0.00180,50863,91.76078,55430
2874,ursuciprian,1,0.00180,50864,91.76258,55430
2875,v3rm0n,1,0.00180,50865,91.76439,55430
2876,vafanassieff,1,0.00180,50866,91.76619,55430
2877,vanillaSprinkles,1,0.00180,50867,91.76800,55430
2878,vanny96,1,0.00180,50868,91.76980,55430
2879,vanvuvuong,1,0.00180,50869,91.77160,55430
2880,vap78,1,0.00180,50870,91.77341,55430
2881,varaprasadh,1,0.00180,50871,91.77521,55430
2882,Varjoissa,1,0.00180,50872,91.77702,55430
2883,varnav,1,0.00180,50873,91.77882,55430
2884,varshneydevansh,1,0.00180,50874,91.78062,55430
2885,vaspoz,1,0.00180,50875,91.78243,55430
2886,vBuravlev,1,0.00180,50876,91.78423,55430
2887,vburckhardt,1,0.00180,50877,91.78604,55430
2888,vdupain,1,0.00180,50878,91.78784,55430
2889,v-eelhomsi,1,0.00180,50879,91.78964,55430
2890,venugopal83k,1,0.00180,50880,91.79145,55430
2891,vermacodes,1,0.00180,50881,91.79325,55430
2892,Vetrenik,1,0.00180,50882,91.79506,55430
2893,vhao27,1,0.00180,50883,91.79686,55430
2894,VictorCodesseira,1,0.00180,50884,91.79866,55430
2895,vidhill,1,0.00180,50885,91.80047,55430
2896,vierkean,1,0.00180,50886,91.80227,55430
2897,ViktorCollin,1,0.00180,50887,91.80408,55430
2898,viktorix,1,0.00180,50888,91.80588,55430
2899,ViktorOrda,1,0.00180,50889,91.80769,55430
2900,vinaysaraogiloopio,1,0.00180,50890,91.80949,55430
2901,vineetps,1,0.00180,50891,91.81129,55430
2902,vinicinbgs,1,0.00180,50892,91.81310,55430
2903,Viriathus1,1,0.00180,50893,91.81490,55430
2904,Virus2466,1,0.00180,50894,91.81671,55430
2905,vishnubraj,1,0.00180,50895,91.81851,55430
2906,vishnus,1,0.00180,50896,91.82031,55430
2907,vitaly-dt,1,0.00180,50897,91.82212,55430
2908,vitkin,1,0.00180,50898,91.82392,55430
2909,vivekthangamuthu,1,0.00180,50899,91.82573,55430
2910,vivian-rook,1,0.00180,50900,91.82753,55430
2911,vkv,1,0.00180,50901,91.82933,55430
2912,vladcristi,1,0.00180,50902,91.83114,55430
2913,VladimirTyrin,1,0.00180,50903,91.83294,55430
2914,vladon,1,0.00180,50904,91.83475,55430
2915,VladosK0k0s,1,0.00180,50905,91.83655,55430
2916,vladrassokhin,1,0.00180,50906,91.83835,55430
2917,vmatsiiako,1,0.00180,50907,91.84016,55430
2918,vnmsklnk,1,0.00180,50908,91.84196,55430
2919,Volatus,1,0.00180,50909,91.84377,55430
2920,voxpelli,1,0.00180,50910,91.84557,55430
2921,vszabo2,1,0.00180,50911,91.84738,55430
2922,vvdaal,1,0.00180,50912,91.84918,55430
2923,vwbusguy,1,0.00180,50913,91.85098,55430
2924,vx-i,1,0.00180,50914,91.85279,55430
2925,vzilinas,1,0.00180,50915,91.85459,55430
2926,waddles,1,0.00180,50916,91.85640,55430
2927,wadimdz,1,0.00180,50917,91.85820,55430
2928,WairimuAbigaelWairimu,1,0.00180,50918,91.86000,55430
2929,waiyan1612,1,0.00180,50919,91.86181,55430
2930,walkoaw,1,0.00180,50920,91.86361,55430
2931,wariorx,1,0.00180,50921,91.86542,55430
2932,wasinsandiego,1,0.00180,50922,91.86722,55430
2933,WatcherWhale,1,0.00180,50923,91.86902,55430
2934,wawm,1,0.00180,50924,91.87083,55430
2935,Wayneoween,1,0.00180,50925,91.87263,55430
2936,wcmjunior,1,0.00180,50926,91.87444,55430
2937,wdragos,1,0.00180,50927,91.87624,55430
2938,weapdiv-david,1,0.00180,50928,91.87804,55430
2939,weaversam8,1,0.00180,50929,91.87985,55430
2940,WesleyCharlesBlake,1,0.00180,50930,91.88165,55430
2941,wesleykirkland,1,0.00180,50931,91.88346,55430
2942,wi1w,1,0.00180,50932,91.88526,55430
2943,wiegandf,1,0.00180,50933,91.88706,55430
2944,will-86,1,0.00180,50934,91.88887,55430
2945,Willem-van-hove,1,0.00180,50935,91.89067,55430
2946,WilliamDGH,1,0.00180,50936,91.89248,55430
2947,WilliamVannuffelen,1,0.00180,50937,91.89428,55430
2948,WillS-VG,1,0.00180,50938,91.89609,55430
2949,willwee,1,0.00180,50939,91.89789,55430
2950,wirkijowski,1,0.00180,50940,91.89969,55430
2951,wmunguiam,1,0.00180,50941,91.90150,55430
2952,wobondar,1,0.00180,50942,91.90330,55430
2953,wokalek,1,0.00180,50943,91.90511,55430
2954,wonderphil,1,0.00180,50944,91.90691,55430
2955,wongCH,1,0.00180,50945,91.90871,55430
2956,wparad,1,0.00180,50946,91.91052,55430
2957,wpessers,1,0.00180,50947,91.91232,55430
2958,WPJorge,1,0.00180,50948,91.91413,55430
2959,wrp,1,0.00180,50949,91.91593,55430
2960,wyewlee,1,0.00180,50950,91.91773,55430
2961,Xanazf,1,0.00180,50951,91.91954,55430
2962,xargs-P,1,0.00180,50952,91.92134,55430
2963,xaviermignot,1,0.00180,50953,91.92315,55430
2964,xiloss,1,0.00180,50954,91.92495,55430
2965,xlejakx,1,0.00180,50955,91.92675,55430
2966,xneyder,1,0.00180,50956,91.92856,55430
2967,xosupernova,1,0.00180,50957,91.93036,55430
2968,XP2600-hub,1,0.00180,50958,91.93217,55430
2969,xyhhx,1,0.00180,50959,91.93397,55430
2970,xyq175com,1,0.00180,50960,91.93577,55430
2971,yaooluu,1,0.00180,50961,91.93758,55430
2972,yaput,1,0.00180,50962,91.93938,55430
2973,yashafromrussia,1,0.00180,50963,91.94119,55430
2974,YashrajRathi,1,0.00180,50964,91.94299,55430
2975,ycamargo,1,0.00180,50965,91.94480,55430
2976,yelinaung-tw,1,0.00180,50966,91.94660,55430
2977,yelsaw,1,0.00180,50967,91.94840,55430
2978,yeminiori,1,0.00180,50968,91.95021,55430
2979,YFortin,1,0.00180,50969,91.95201,55430
2980,yfvham,1,0.00180,50970,91.95382,55430
2981,yhamano0312,1,0.00180,50971,91.95562,55430
2982,y-kimura-q,1,0.00180,50972,91.95742,55430
2983,yktakaha4,1,0.00180,50973,91.95923,55430
2984,yloose,1,0.00180,50974,91.96103,55430
2985,yoo,1,0.00180,50975,91.96284,55430
2986,yozoraozora,1,0.00180,50976,91.96464,55430
2987,YroslavNykolyshyn,1,0.00180,50977,91.96644,55430
2988,ysb33r,1,0.00180,50978,91.96825,55430
2989,yuto-ohta,1,0.00180,50979,91.97005,55430
2990,Yzrsah,1,0.00180,50980,91.97186,55430
2991,zachreborn,1,0.00180,50981,91.97366,55430
2992,ZaidAfane3,1,0.00180,50982,91.97546,55430
2993,zaidmohd,1,0.00180,50983,91.97727,55430
2994,Zain-Bin-Arshad,1,0.00180,50984,91.97907,55430
2995,zapotah,1,0.00180,50985,91.98088,55430
2996,Zer0ot,1,0.00180,50986,91.98268,55430
2997,zero-pytagoras,1,0.00180,50987,91.98448,55430
2998,zfiel,1,0.00180,50988,91.98629,55430
2999,zhcli,1,0.00180,50989,91.98809,55430
3000,zillag,1,0.00180,50990,91.98990,55430
3001,ZilvinasKucinskas,1,0.00180,50991,91.99170,55430
3002,Ziziann,1,0.00180,50992,91.99351,55430
3003,zoispag,1,0.00180,50993,91.99531,55430
3004,zonywhoop,1,0.00180,50994,91.99711,55430
3005,Zordrak,1,0.00180,50995,91.99892,55430
3006,zuchka,1,0.00180,50996,92.00072,55430
3007,Zulcom,1,0.00180,50997,92.00253,55430
3008,zyzyx03,1,0.00180,50998,92.00433,55430
