rank_number,actor,contributions,percent,cumulative_sum,cumulative_percent,all_contributions
1,Pallavi-PH,1305,0.75853,1305,0.75853,172043
2,openebs-pro-sa,866,0.50336,2171,1.26189,172043
3,satyapriyamishra222,819,0.47604,2990,1.73794,172043
4,rakeshPRaghu,643,0.37374,3633,2.11168,172043
5,tjoshum,271,0.15752,3904,2.26920,172043
6,AJDatacore,228,0.13253,4132,2.40173,172043
7,zeenix,126,0.07324,4258,2.47496,172043
8,yannis218,122,0.07091,4380,2.54588,172043
9,datacore-vkumar,101,0.05871,4481,2.60458,172043
10,vaniisgh,95,0.05522,4576,2.65980,172043
11,vipulgupta2048,93,0.05406,4669,2.71386,172043
12,jamie-0,76,0.04418,4745,2.75803,172043
13,jtcarnes,73,0.04243,4818,2.80046,172043
14,datacore-gthomas,65,0.03778,4883,2.83824,172043
15,nareshdesh,65,0.03778,4948,2.87603,172043
16,praveengt,65,0.03778,5013,2.91381,172043
17,felix1209,62,0.03604,5075,2.94984,172043
18,zlymeda,61,0.03546,5136,2.98530,172043
19,almas33,51,0.02964,5187,3.01494,172043
20,felix1972,48,0.02790,5235,3.04284,172043
21,jnels124,41,0.02383,5276,3.06668,172043
22,NaveenBellary,40,0.02325,5316,3.08993,172043
23,Apollo9999,39,0.02267,5355,3.11259,172043
24,cospotato,39,0.02267,5394,3.13526,172043
25,todeb,39,0.02267,5433,3.15793,172043
26,aamirqs,38,0.02209,5471,3.18002,172043
27,hasethuraman,38,0.02209,5509,3.20211,172043
28,MaisenbacherD,37,0.02151,5546,3.22361,172043
29,wibed,35,0.02034,5581,3.24396,172043
30,AJEETRAI707,34,0.01976,5615,3.26372,172043
31,bhuism,33,0.01918,5648,3.28290,172043
32,Ornias1993,31,0.01802,5679,3.30092,172043
33,vakul-gupta-flp,31,0.01802,5710,3.31894,172043
34,liuminjian,30,0.01744,5740,3.33638,172043
35,harridu,29,0.01686,5769,3.35323,172043
36,jadsy2107,26,0.01511,5795,3.36834,172043
37,stevefan1999-personal,26,0.01511,5821,3.38346,172043
38,akashshah26595,25,0.01453,5846,3.39799,172043
39,allanian,25,0.01453,5871,3.41252,172043
40,bharathpgp,25,0.01453,5896,3.42705,172043
41,lixiaopengxiya,25,0.01453,5921,3.44158,172043
42,cinapm,24,0.01395,5945,3.45553,172043
43,cleveritcz,24,0.01395,5969,3.46948,172043
44,ianb-mp,24,0.01395,5993,3.48343,172043
45,mathagician,24,0.01395,6017,3.49738,172043
46,veenadong,24,0.01395,6041,3.51133,172043
47,keydrevolta,23,0.01337,6064,3.52470,172043
48,maheshreddy7797,23,0.01337,6087,3.53807,172043
49,codegagan,22,0.01279,6109,3.55086,172043
50,itsek,22,0.01279,6131,3.56364,172043
51,kaitaklam,22,0.01279,6153,3.57643,172043
52,pratik97,22,0.01279,6175,3.58922,172043
53,xigifty,22,0.01279,6197,3.60201,172043
54,kaushikp13,21,0.01221,6218,3.61421,172043
55,synthe102,21,0.01221,6239,3.62642,172043
56,vikgaur,21,0.01221,6260,3.63863,172043
57,innotecsol,20,0.01163,6280,3.65025,172043
58,kro-cat,20,0.01163,6300,3.66188,172043
59,MrWako,20,0.01163,6320,3.67350,172043
60,SVronskiy,20,0.01163,6340,3.68513,172043
61,briankmatheson,19,0.01104,6359,3.69617,172043
62,sch00lb0y,19,0.01104,6378,3.70721,172043
63,Daxcor69,18,0.01046,6396,3.71768,172043
64,ryandellolio,18,0.01046,6414,3.72814,172043
65,brute4s99,17,0.00988,6431,3.73802,172043
66,bxy4543,17,0.00988,6448,3.74790,172043
67,dborman-hpe,17,0.00988,6465,3.75778,172043
68,dpisanu,17,0.00988,6482,3.76766,172043
69,dyasny,17,0.00988,6499,3.77754,172043
70,Mosibi,17,0.00988,6516,3.78743,172043
71,rockydcoder,17,0.00988,6533,3.79731,172043
72,artw,16,0.00930,6549,3.80661,172043
73,bilal-mk,16,0.00930,6565,3.81591,172043
74,cbanupama,16,0.00930,6581,3.82521,172043
75,dingsongjie,16,0.00930,6597,3.83451,172043
76,divyanshkul,16,0.00930,6613,3.84381,172043
77,ianroberts,16,0.00930,6629,3.85311,172043
78,mikeBashStuff,16,0.00930,6645,3.86241,172043
79,neoaggelos,16,0.00930,6661,3.87171,172043
80,prratadiya,16,0.00930,6677,3.88101,172043
81,rgembalik,16,0.00930,6693,3.89031,172043
82,StrikerRUS,16,0.00930,6709,3.89961,172043
83,thepriefy,16,0.00930,6725,3.90891,172043
84,windowsrefund,16,0.00930,6741,3.91821,172043
85,Amishakumari544,15,0.00872,6756,3.92693,172043
86,dhs-rec,15,0.00872,6771,3.93564,172043
87,geekyd,15,0.00872,6786,3.94436,172043
88,KevinWhalen,15,0.00872,6801,3.95308,172043
89,laurivosandi,15,0.00872,6816,3.96180,172043
90,njuptlzf,15,0.00872,6831,3.97052,172043
91,ronaldyuwandika,15,0.00872,6846,3.97924,172043
92,SadPandaBear,15,0.00872,6861,3.98796,172043
93,ulshell,15,0.00872,6876,3.99668,172043
94,vyaspranjal33,15,0.00872,6891,4.00539,172043
95,AlexanderHamza,14,0.00814,6905,4.01353,172043
96,jianghushinian,14,0.00814,6919,4.02167,172043
97,jj-2020,14,0.00814,6933,4.02981,172043
98,MengjinWu,14,0.00814,6947,4.03794,172043
99,Naveenkhasyap,14,0.00814,6961,4.04608,172043
100,nvzard,14,0.00814,6975,4.05422,172043
101,rafa-acioly,14,0.00814,6989,4.06236,172043
102,rafihnl,14,0.00814,7003,4.07049,172043
103,sushiMix,14,0.00814,7017,4.07863,172043
104,Yaxian,14,0.00814,7031,4.08677,172043
105,anuragsachdeva28,13,0.00756,7044,4.09433,172043
106,AshishMhrzn10,13,0.00756,7057,4.10188,172043
107,ferozbaig96,13,0.00756,7070,4.10944,172043
108,harisanker1780,13,0.00756,7083,4.11699,172043
109,houwenchen,13,0.00756,7096,4.12455,172043
110,jsalatiel,13,0.00756,7109,4.13211,172043
111,kichloo,13,0.00756,7122,4.13966,172043
112,prankshaw,13,0.00756,7135,4.14722,172043
113,sharur7,13,0.00756,7148,4.15478,172043
114,swetax,13,0.00756,7161,4.16233,172043
115,wataruian,13,0.00756,7174,4.16989,172043
116,actions,12,0.00698,7186,4.17686,172043
117,AlexanderDotH,12,0.00698,7198,4.18384,172043
118,fzyzcjy,12,0.00698,7210,4.19081,172043
119,gupta2140,12,0.00698,7222,4.19779,172043
120,infiniteoverflow,12,0.00698,7234,4.20476,172043
121,krishnakarthik1309,12,0.00698,7246,4.21174,172043
122,kundeng,12,0.00698,7258,4.21871,172043
123,maikotz,12,0.00698,7270,4.22569,172043
124,NerdyPepper,12,0.00698,7282,4.23266,172043
125,pando85,12,0.00698,7294,4.23964,172043
126,Skchoudhary,12,0.00698,7306,4.24661,172043
127,solarisfire,12,0.00698,7318,4.25359,172043
128,sushma1118,12,0.00698,7330,4.26056,172043
129,wowditi,12,0.00698,7342,4.26754,172043
130,abhisheksinghbaghel,11,0.00639,7353,4.27393,172043
131,AChangFeng,11,0.00639,7364,4.28033,172043
132,ananbas,11,0.00639,7375,4.28672,172043
133,dcaputo-harmoni,11,0.00639,7386,4.29311,172043
134,drraghavendra,11,0.00639,7397,4.29951,172043
135,Ericra95,11,0.00639,7408,4.30590,172043
136,lisaychuang,11,0.00639,7419,4.31229,172043
137,lnsyyj,11,0.00639,7430,4.31869,172043
138,Logan1x,11,0.00639,7441,4.32508,172043
139,pckroon,11,0.00639,7452,4.33148,172043
140,rishabhp99,11,0.00639,7463,4.33787,172043
141,riya24899,11,0.00639,7474,4.34426,172043
142,sanyasabu,11,0.00639,7485,4.35066,172043
143,sark01,11,0.00639,7496,4.35705,172043
144,Sumindar,11,0.00639,7507,4.36344,172043
145,trishitapingolia,11,0.00639,7518,4.36984,172043
146,abhishek-19,10,0.00581,7528,4.37565,172043
147,arpt-svt,10,0.00581,7538,4.38146,172043
148,aryanrawlani28,10,0.00581,7548,4.38728,172043
149,Atharex,10,0.00581,7558,4.39309,172043
150,divygarg,10,0.00581,7568,4.39890,172043
151,dnugmanov,10,0.00581,7578,4.40471,172043
152,md-yaseen,10,0.00581,7588,4.41053,172043
153,mhemrg,10,0.00581,7598,4.41634,172043
154,morrme,10,0.00581,7608,4.42215,172043
155,nicholascioli,10,0.00581,7618,4.42796,172043
156,OussamaSALAHOUELHADJ,10,0.00581,7628,4.43378,172043
157,sarnava1,10,0.00581,7638,4.43959,172043
158,sombat-cha,10,0.00581,7648,4.44540,172043
159,sonapraneeth-a,10,0.00581,7658,4.45121,172043
160,vkmrishad,10,0.00581,7668,4.45703,172043
161,vmr1532,10,0.00581,7678,4.46284,172043
162,631068264,9,0.00523,7687,4.46807,172043
163,ahlgol,9,0.00523,7696,4.47330,172043
164,amithkr,9,0.00523,7705,4.47853,172043
165,benkim0414,9,0.00523,7714,4.48376,172043
166,edorid,9,0.00523,7723,4.48899,172043
167,geier,9,0.00523,7732,4.49423,172043
168,gentios,9,0.00523,7741,4.49946,172043
169,ggarg2906sumo,9,0.00523,7750,4.50469,172043
170,gy741,9,0.00523,7759,4.50992,172043
171,hari-sanker,9,0.00523,7768,4.51515,172043
172,heygroot,9,0.00523,7777,4.52038,172043
173,Hrishike,9,0.00523,7786,4.52561,172043
174,hsteude,9,0.00523,7795,4.53084,172043
175,huangfangfeng,9,0.00523,7804,4.53608,172043
176,idivyanshbansal,9,0.00523,7813,4.54131,172043
177,kaustumbh7,9,0.00523,7822,4.54654,172043
178,kn-neelalohitha,9,0.00523,7831,4.55177,172043
179,luantranminh,9,0.00523,7840,4.55700,172043
180,nobiit,9,0.00523,7849,4.56223,172043
181,omric-runai,9,0.00523,7858,4.56746,172043
182,panos,9,0.00523,7867,4.57269,172043
183,raghavarora16,9,0.00523,7876,4.57793,172043
184,ShaakhaBrahma,9,0.00523,7885,4.58316,172043
185,shendrekbharath,9,0.00523,7894,4.58839,172043
186,shindakun,9,0.00523,7903,4.59362,172043
187,Shivam7-1,9,0.00523,7912,4.59885,172043
188,sjerman,9,0.00523,7921,4.60408,172043
189,tathougies,9,0.00523,7930,4.60931,172043
190,ThorbenJ,9,0.00523,7939,4.61454,172043
191,vinayak42,9,0.00523,7948,4.61978,172043
192,von1994,9,0.00523,7957,4.62501,172043
193,xtaraim,9,0.00523,7966,4.63024,172043
194,zzzuzik,9,0.00523,7975,4.63547,172043
195,13567436138,8,0.00465,7983,4.64012,172043
196,aakash2602,8,0.00465,7991,4.64477,172043
197,Abby3017,8,0.00465,7999,4.64942,172043
198,ananya7,8,0.00465,8007,4.65407,172043
199,Anil1331,8,0.00465,8015,4.65872,172043
200,AntonOfTheWoods,8,0.00465,8023,4.66337,172043
201,ayan-b,8,0.00465,8031,4.66802,172043
202,benjaminmisell,8,0.00465,8039,4.67267,172043
203,daniel-shuy,8,0.00465,8047,4.67732,172043
204,dcswbdias,8,0.00465,8055,4.68197,172043
205,dhess,8,0.00465,8063,4.68662,172043
206,doruboyina,8,0.00465,8071,4.69127,172043
207,dread-uo,8,0.00465,8079,4.69592,172043
208,emiran-orange,8,0.00465,8087,4.70057,172043
209,FestivalBobcats,8,0.00465,8095,4.70522,172043
210,Giom-fm,8,0.00465,8103,4.70987,172043
211,heppstux,8,0.00465,8111,4.71452,172043
212,hugovk,8,0.00465,8119,4.71917,172043
213,krishnakekan19,8,0.00465,8127,4.72382,172043
214,krishnakekan619,8,0.00465,8135,4.72847,172043
215,LinQing2017,8,0.00465,8143,4.73312,172043
216,lizhifengones,8,0.00465,8151,4.73777,172043
217,MightyRaymond,8,0.00465,8159,4.74242,172043
218,mike-pisman,8,0.00465,8167,4.74707,172043
219,MrMarble,8,0.00465,8175,4.75172,172043
220,nAnderYang,8,0.00465,8183,4.75637,172043
221,nfayazov,8,0.00465,8191,4.76102,172043
222,open-source-explorer,8,0.00465,8199,4.76567,172043
223,patheticpat,8,0.00465,8207,4.77032,172043
224,rhrytskiv,8,0.00465,8215,4.77497,172043
225,RytisLT,8,0.00465,8223,4.77962,172043
226,Satvik08,8,0.00465,8231,4.78427,172043
227,SoGooDFR,8,0.00465,8239,4.78892,172043
228,Someshbose,8,0.00465,8247,4.79357,172043
229,sparkingdark,8,0.00465,8255,4.79822,172043
230,TProhofsky,8,0.00465,8263,4.80287,172043
231,Trolldemorted,8,0.00465,8271,4.80752,172043
232,Tushcr7,8,0.00465,8279,4.81217,172043
233,abhisheklakra007,7,0.00407,8286,4.81624,172043
234,agarwal-akash,7,0.00407,8293,4.82031,172043
235,AishwaryaVarma,7,0.00407,8300,4.82438,172043
236,albertogviana,7,0.00407,8307,4.82844,172043
237,alex3305,7,0.00407,8314,4.83251,172043
238,amiya-1998,7,0.00407,8321,4.83658,172043
239,AndreasBomholtz,7,0.00407,8328,4.84065,172043
240,archit041198,7,0.00407,8335,4.84472,172043
241,ashishknitcs,7,0.00407,8342,4.84879,172043
242,bernardgut,7,0.00407,8349,4.85286,172043
243,bharath-acchu,7,0.00407,8356,4.85693,172043
244,cxfcxf,7,0.00407,8363,4.86099,172043
245,daming6,7,0.00407,8370,4.86506,172043
246,danimart1991,7,0.00407,8377,4.86913,172043
247,dev-wei,7,0.00407,8384,4.87320,172043
248,diegous,7,0.00407,8391,4.87727,172043
249,dude051,7,0.00407,8398,4.88134,172043
250,erbiao3k,7,0.00407,8405,4.88541,172043
251,frasmarco,7,0.00407,8412,4.88948,172043
252,hack3r-0m,7,0.00407,8419,4.89354,172043
253,Heesenp,7,0.00407,8426,4.89761,172043
254,husseinharake,7,0.00407,8433,4.90168,172043
255,joekhoobyar,7,0.00407,8440,4.90575,172043
256,Johnaius,7,0.00407,8447,4.90982,172043
257,jshin47,7,0.00407,8454,4.91389,172043
258,KalagaSahitya,7,0.00407,8461,4.91796,172043
259,kranurag7,7,0.00407,8468,4.92203,172043
260,kratos81,7,0.00407,8475,4.92609,172043
261,Lucaber,7,0.00407,8482,4.93016,172043
262,ManavpreetSingh,7,0.00407,8489,4.93423,172043
263,medarametlahimabindu,7,0.00407,8496,4.93830,172043
264,miguelcostaUI,7,0.00407,8503,4.94237,172043
265,mpartel,7,0.00407,8510,4.94644,172043
266,MuthukumarHelios,7,0.00407,8517,4.95051,172043
267,netom,7,0.00407,8524,4.95458,172043
268,OlafHappyson,7,0.00407,8531,4.95864,172043
269,pinghe,7,0.00407,8538,4.96271,172043
270,poojan-dalal,7,0.00407,8545,4.96678,172043
271,pranjalv9,7,0.00407,8552,4.97085,172043
272,ptrjeffrey,7,0.00407,8559,4.97492,172043
273,RajuKalidindi,7,0.00407,8566,4.97899,172043
274,Rid,7,0.00407,8573,4.98306,172043
275,rjstyles,7,0.00407,8580,4.98713,172043
276,rsiva911,7,0.00407,8587,4.99119,172043
277,ryanrolds,7,0.00407,8594,4.99526,172043
278,sa9226,7,0.00407,8601,4.99933,172043
279,shahidafrid526,7,0.00407,8608,5.00340,172043
280,siegfriedhoellrigl,7,0.00407,8615,5.00747,172043
281,sivaramdinesh,7,0.00407,8622,5.01154,172043
282,snyamars,7,0.00407,8629,5.01561,172043
283,Sojaner,7,0.00407,8636,5.01968,172043
284,Subhamverma2407,7,0.00407,8643,5.02374,172043
285,sushma-priyadharssini,7,0.00407,8650,5.02781,172043
286,Szpadel,7,0.00407,8657,5.03188,172043
287,thasviya,7,0.00407,8664,5.03595,172043
288,tidux,7,0.00407,8671,5.04002,172043
289,yh0xa55a8,7,0.00407,8678,5.04409,172043
290,yuvi17,7,0.00407,8685,5.04816,172043
291,zeeshanalisyed,7,0.00407,8692,5.05223,172043
292,adsrc,6,0.00349,8698,5.05571,172043
293,akshatnitd,6,0.00349,8704,5.05920,172043
294,amiteshenoy,6,0.00349,8710,5.06269,172043
295,andreathniah,6,0.00349,8716,5.06618,172043
296,avnish98,6,0.00349,8722,5.06966,172043
297,aytekk,6,0.00349,8728,5.07315,172043
298,benedictflorance,6,0.00349,8734,5.07664,172043
299,benn0r,6,0.00349,8740,5.08013,172043
300,beschoenen,6,0.00349,8746,5.08361,172043
301,Bharat123rox,6,0.00349,8752,5.08710,172043
302,cartinez,6,0.00349,8758,5.09059,172043
303,chanyshev,6,0.00349,8764,5.09408,172043
304,cxong,6,0.00349,8770,5.09756,172043
305,czakarian,6,0.00349,8776,5.10105,172043
306,damsehgal,6,0.00349,8782,5.10454,172043
307,deepakjayaprakash,6,0.00349,8788,5.10803,172043
308,DeprecatedLuke,6,0.00349,8794,5.11151,172043
309,diehard-coder,6,0.00349,8800,5.11500,172043
310,divayprakash,6,0.00349,8806,5.11849,172043
311,droidcafe,6,0.00349,8812,5.12198,172043
312,dung-tien-nguyen,6,0.00349,8818,5.12546,172043
313,dxf,6,0.00349,8824,5.12895,172043
314,edawine,6,0.00349,8830,5.13244,172043
315,elias-dbx,6,0.00349,8836,5.13593,172043
316,floatious,6,0.00349,8842,5.13941,172043
317,galihmelon,6,0.00349,8848,5.14290,172043
318,geneliu,6,0.00349,8854,5.14639,172043
319,GitCop,6,0.00349,8860,5.14988,172043
320,gorlapraveen,6,0.00349,8866,5.15336,172043
321,Hard-Coder05,6,0.00349,8872,5.15685,172043
322,hflamboauto1,6,0.00349,8878,5.16034,172043
323,hnifmaghfur,6,0.00349,8884,5.16383,172043
324,jjjighg,6,0.00349,8890,5.16731,172043
325,joselbr2099,6,0.00349,8896,5.17080,172043
326,kangco-de,6,0.00349,8902,5.17429,172043
327,Kurolox,6,0.00349,8908,5.17778,172043
328,LiTO773,6,0.00349,8914,5.18126,172043
329,loliklol,6,0.00349,8920,5.18475,172043
330,lologarithm,6,0.00349,8926,5.18824,172043
331,mayavuser,6,0.00349,8932,5.19173,172043
332,midhunbiju,6,0.00349,8938,5.19521,172043
333,MrL1605,6,0.00349,8944,5.19870,172043
334,namnp081296,6,0.00349,8950,5.20219,172043
335,NexWeb,6,0.00349,8956,5.20568,172043
336,noyessie,6,0.00349,8962,5.20916,172043
337,parammittal16,6,0.00349,8968,5.21265,172043
338,phhutter,6,0.00349,8974,5.21614,172043
339,prahaladbelavadi,6,0.00349,8980,5.21963,172043
340,RajatGarg97,6,0.00349,8986,5.22311,172043
341,ramitsawhney27,6,0.00349,8992,5.22660,172043
342,RanadeepPolavarapu,6,0.00349,8998,5.23009,172043
343,rhugga,6,0.00349,9004,5.23358,172043
344,safl,6,0.00349,9010,5.23706,172043
345,sakshamtaneja21,6,0.00349,9016,5.24055,172043
346,salonirk11,6,0.00349,9022,5.24404,172043
347,sambhav2612,6,0.00349,9028,5.24753,172043
348,Sam-Lin-MillersLab,6,0.00349,9034,5.25101,172043
349,sbidoul,6,0.00349,9040,5.25450,172043
350,simrankureel,6,0.00349,9046,5.25799,172043
351,snehalbiju12,6,0.00349,9052,5.26148,172043
352,ssytnikov18,6,0.00349,9058,5.26496,172043
353,theramis,6,0.00349,9064,5.26845,172043
354,tho861998,6,0.00349,9070,5.27194,172043
355,tingaloo,6,0.00349,9076,5.27543,172043
356,tom-vthptvh,6,0.00349,9082,5.27891,172043
357,trathborne,6,0.00349,9088,5.28240,172043
358,tsteine,6,0.00349,9094,5.28589,172043
359,ukd1,6,0.00349,9100,5.28938,172043
360,umagnus,6,0.00349,9106,5.29286,172043
361,vildek,6,0.00349,9112,5.29635,172043
362,vishaaal,6,0.00349,9118,5.29984,172043
363,wing328,6,0.00349,9124,5.30333,172043
364,15bcs019,5,0.00291,9129,5.30623,172043
365,aasseman,5,0.00291,9134,5.30914,172043
366,aj07,5,0.00291,9139,5.31204,172043
367,alexandrujieanu,5,0.00291,9144,5.31495,172043
368,alwinmark,5,0.00291,9149,5.31786,172043
369,amitsagargowda,5,0.00291,9154,5.32076,172043
370,andrewnester,5,0.00291,9159,5.32367,172043
371,anmshkmr,5,0.00291,9164,5.32658,172043
372,arjunmr,5,0.00291,9169,5.32948,172043
373,asoltesz,5,0.00291,9174,5.33239,172043
374,balous,5,0.00291,9179,5.33529,172043
375,bbashy,5,0.00291,9184,5.33820,172043
376,bihanviranga,5,0.00291,9189,5.34111,172043
377,bob-gray,5,0.00291,9194,5.34401,172043
378,bombsimon,5,0.00291,9199,5.34692,172043
379,brihijoshi,5,0.00291,9204,5.34983,172043
380,carlosrodfern,5,0.00291,9209,5.35273,172043
381,chornlgscout,5,0.00291,9214,5.35564,172043
382,cjorge-graphops,5,0.00291,9219,5.35854,172043
383,Cogitri,5,0.00291,9224,5.36145,172043
384,Daniel-Nashed,5,0.00291,9229,5.36436,172043
385,Davincible,5,0.00291,9234,5.36726,172043
386,disc,5,0.00291,9239,5.37017,172043
387,dmallubhotla,5,0.00291,9244,5.37308,172043
388,dmonoquant,5,0.00291,9249,5.37598,172043
389,dodobhoot,5,0.00291,9254,5.37889,172043
390,elishemer,5,0.00291,9259,5.38179,172043
391,Endi1,5,0.00291,9264,5.38470,172043
392,fdmarcin,5,0.00291,9269,5.38761,172043
393,footplus,5,0.00291,9274,5.39051,172043
394,fortrieb,5,0.00291,9279,5.39342,172043
395,fragolinux,5,0.00291,9284,5.39633,172043
396,gahag,5,0.00291,9289,5.39923,172043
397,geeksterio,5,0.00291,9294,5.40214,172043
398,Goobaii,5,0.00291,9299,5.40504,172043
399,goodidea-kp,5,0.00291,9304,5.40795,172043
400,Iamchotusri,5,0.00291,9309,5.41086,172043
401,iPenx,5,0.00291,9314,5.41376,172043
402,ivanuy,5,0.00291,9319,5.41667,172043
403,i-vikash,5,0.00291,9324,5.41958,172043
404,jcjveraa,5,0.00291,9329,5.42248,172043
405,jeanmorais,5,0.00291,9334,5.42539,172043
406,jemershaw,5,0.00291,9339,5.42829,172043
407,k1slay,5,0.00291,9344,5.43120,172043
408,KaranSinghBisht,5,0.00291,9349,5.43411,172043
409,kckeiks,5,0.00291,9354,5.43701,172043
410,koss822,5,0.00291,9359,5.43992,172043
411,kwehen,5,0.00291,9364,5.44283,172043
412,lambainsaan,5,0.00291,9369,5.44573,172043
413,Lavasocks,5,0.00291,9374,5.44864,172043
414,lucasqueiroz,5,0.00291,9379,5.45154,172043
415,madalinignisca,5,0.00291,9384,5.45445,172043
416,mchtech,5,0.00291,9389,5.45736,172043
417,Mechputer,5,0.00291,9394,5.46026,172043
418,michael-db,5,0.00291,9399,5.46317,172043
419,mikroskeem,5,0.00291,9404,5.46608,172043
420,molszewska95,5,0.00291,9409,5.46898,172043
421,Naveenjnv22,5,0.00291,9414,5.47189,172043
422,NicoG60,5,0.00291,9419,5.47479,172043
423,nikitaankita,5,0.00291,9424,5.47770,172043
424,omi10859,5,0.00291,9429,5.48061,172043
425,palash16,5,0.00291,9434,5.48351,172043
426,postmeback,5,0.00291,9439,5.48642,172043
427,prakharshreyash15,5,0.00291,9444,5.48933,172043
428,quickerdevops,5,0.00291,9449,5.49223,172043
429,rahulkumaran,5,0.00291,9454,5.49514,172043
430,RandomGHUser,5,0.00291,9459,5.49804,172043
431,rm3l,5,0.00291,9464,5.50095,172043
432,ryshoooo,5,0.00291,9469,5.50386,172043
433,saideepd,5,0.00291,9474,5.50676,172043
434,sanket0896,5,0.00291,9479,5.50967,172043
435,sdelrio,5,0.00291,9484,5.51258,172043
436,shazadbrohi,5,0.00291,9489,5.51548,172043
437,ShubhamB99,5,0.00291,9494,5.51839,172043
438,ShubhamSood1406,5,0.00291,9499,5.52129,172043
439,SiddhantD,5,0.00291,9504,5.52420,172043
440,SiddharthMahapatra12,5,0.00291,9509,5.52711,172043
441,Soundharyaam,5,0.00291,9514,5.53001,172043
442,SteelCrow,5,0.00291,9519,5.53292,172043
443,Subetov,5,0.00291,9524,5.53583,172043
444,Sweta271097,5,0.00291,9529,5.53873,172043
445,Taranzz25,5,0.00291,9534,5.54164,172043
446,th-2021,5,0.00291,9539,5.54454,172043
447,torongu,5,0.00291,9544,5.54745,172043
448,urbaman,5,0.00291,9549,5.55036,172043
449,vbtnickn,5,0.00291,9554,5.55326,172043
450,vinayakbhat24,5,0.00291,9559,5.55617,172043
451,wanfuuyu,5,0.00291,9564,5.55908,172043
452,xbulat,5,0.00291,9569,5.56198,172043
453,xx621998xx,5,0.00291,9574,5.56489,172043
454,yelhouti,5,0.00291,9579,5.56779,172043
455,yuweni99,5,0.00291,9584,5.57070,172043
456,zenware,5,0.00291,9589,5.57361,172043
457,0x48piraj,4,0.00233,9593,5.57593,172043
458,1121437613,4,0.00233,9597,5.57826,172043
459,abilash13,4,0.00233,9601,5.58058,172043
460,achiv,4,0.00233,9605,5.58291,172043
461,Aerisu,4,0.00233,9609,5.58523,172043
462,alexanderxc,4,0.00233,9613,5.58756,172043
463,AliceWonderland,4,0.00233,9617,5.58988,172043
464,Aman1440,4,0.00233,9621,5.59221,172043
465,amarshaw,4,0.00233,9625,5.59453,172043
466,Annamaliakal,4,0.00233,9629,5.59686,172043
467,aprex,4,0.00233,9633,5.59918,172043
468,Archaeologist03,4,0.00233,9637,5.60151,172043
469,arijitAD,4,0.00233,9641,5.60383,172043
470,armudgal,4,0.00233,9645,5.60616,172043
471,arpitpandey0209,4,0.00233,9649,5.60848,172043
472,Aryankpoor,4,0.00233,9653,5.61081,172043
473,ashishpatelcs,4,0.00233,9657,5.61313,172043
474,Ash-Shaun,4,0.00233,9661,5.61546,172043
475,aslubsky,4,0.00233,9665,5.61778,172043
476,Axle7XStriker,4,0.00233,9669,5.62011,172043
477,AyushBherwani1998,4,0.00233,9673,5.62243,172043
478,b1r3k,4,0.00233,9677,5.62476,172043
479,badbart,4,0.00233,9681,5.62708,172043
480,Born2Bake,4,0.00233,9685,5.62941,172043
481,cbaumler,4,0.00233,9689,5.63173,172043
482,Cerebus,4,0.00233,9693,5.63406,172043
483,chirag200666,4,0.00233,9697,5.63638,172043
484,codeX1616,4,0.00233,9701,5.63871,172043
485,colussim,4,0.00233,9705,5.64103,172043
486,C-Society,4,0.00233,9709,5.64336,172043
487,D1StrX,4,0.00233,9713,5.64568,172043
488,Danfeng-Wang,4,0.00233,9717,5.64801,172043
489,DanielSmrecnik,4,0.00233,9721,5.65033,172043
490,davidq2q,4,0.00233,9725,5.65266,172043
491,dbackeus,4,0.00233,9729,5.65498,172043
492,DeanHao,4,0.00233,9733,5.65731,172043
493,deeluk,4,0.00233,9737,5.65963,172043
494,DhairyaPatel7,4,0.00233,9741,5.66196,172043
495,DipanshKhandelwal,4,0.00233,9745,5.66428,172043
496,dylex,4,0.00233,9749,5.66661,172043
497,evilezh,4,0.00233,9753,5.66893,172043
498,flaixman,4,0.00233,9757,5.67126,172043
499,flying-kestrel,4,0.00233,9761,5.67358,172043
500,fogs,4,0.00233,9765,5.67591,172043
501,ggingmin,4,0.00233,9769,5.67823,172043
502,ghormoon,4,0.00233,9773,5.68056,172043
503,giovannitgl,4,0.00233,9777,5.68288,172043
504,git-yww,4,0.00233,9781,5.68521,172043
505,Godfunc,4,0.00233,9785,5.68753,172043
506,graphenn,4,0.00233,9789,5.68986,172043
507,GreyXor,4,0.00233,9793,5.69218,172043
508,hammadmashkoor,4,0.00233,9797,5.69451,172043
509,hanqingwu,4,0.00233,9801,5.69683,172043
510,hari4125862,4,0.00233,9805,5.69916,172043
511,HemangiS,4,0.00233,9809,5.70148,172043
512,hppranaav,4,0.00233,9813,5.70381,172043
513,iTechsTR,4,0.00233,9817,5.70613,172043
514,JaswanthRemiel,4,0.00233,9821,5.70846,172043
515,jayheinlein,4,0.00233,9825,5.71078,172043
516,jggc,4,0.00233,9829,5.71311,172043
517,jm7joo,4,0.00233,9833,5.71543,172043
518,JoeyX-u,4,0.00233,9837,5.71776,172043
519,jpflouret,4,0.00233,9841,5.72008,172043
520,juliohm1978,4,0.00233,9845,5.72241,172043
521,karthikramesh18,4,0.00233,9849,5.72473,172043
522,keywinf,4,0.00233,9853,5.72706,172043
523,kiryteo,4,0.00233,9857,5.72938,172043
524,kochurovro,4,0.00233,9861,5.73171,172043
525,kpoos,4,0.00233,9865,5.73403,172043
526,kukacz,4,0.00233,9869,5.73636,172043
527,kuldipshpe,4,0.00233,9873,5.73868,172043
528,light86,4,0.00233,9877,5.74101,172043
529,lordofire,4,0.00233,9881,5.74333,172043
530,lpan,4,0.00233,9885,5.74566,172043
531,MagnumOpus21,4,0.00233,9889,5.74798,172043
532,marcoandredinis,4,0.00233,9893,5.75031,172043
533,mhzae,4,0.00233,9897,5.75263,172043
534,Mia-Dan,4,0.00233,9901,5.75496,172043
535,MingZhang-YBPS,4,0.00233,9905,5.75728,172043
536,mirekphd,4,0.00233,9909,5.75961,172043
537,mohammadkarami2023,4,0.00233,9913,5.76193,172043
538,MrYadro,4,0.00233,9917,5.76426,172043
539,Mryashbhardwaj,4,0.00233,9921,5.76658,172043
540,mtmn,4,0.00233,9925,5.76891,172043
541,nandini12396,4,0.00233,9929,5.77123,172043
542,nathan78906,4,0.00233,9933,5.77356,172043
543,nconnolly1,4,0.00233,9937,5.77588,172043
544,nike38rus,4,0.00233,9941,5.77821,172043
545,omeiirr,4,0.00233,9945,5.78053,172043
546,PallavRastogi165,4,0.00233,9949,5.78286,172043
547,paradxum,4,0.00233,9953,5.78518,172043
548,Paramoshka,4,0.00233,9957,5.78751,172043
549,PedroCisnerosSantana,4,0.00233,9961,5.78983,172043
550,pieveee,4,0.00233,9965,5.79216,172043
551,pktharindu,4,0.00233,9969,5.79448,172043
552,prnvdixit,4,0.00233,9973,5.79681,172043
553,psycho-ir,4,0.00233,9977,5.79913,172043
554,ptthon,4,0.00233,9981,5.80146,172043
555,Q-Mart,4,0.00233,9985,5.80378,172043
556,RachelAmbler,4,0.00233,9989,5.80611,172043
557,Raghav17,4,0.00233,9993,5.80843,172043
558,rampreeth,4,0.00233,9997,5.81076,172043
559,rgaduput,4,0.00233,10001,5.81308,172043
560,RichardPointon,4,0.00233,10005,5.81541,172043
561,Rishik233,4,0.00233,10009,5.81773,172043
562,robert83ft,4,0.00233,10013,5.82006,172043
563,robinhuiser,4,0.00233,10017,5.82238,172043
564,Rutam21,4,0.00233,10021,5.82471,172043
565,sarthakvdev,4,0.00233,10025,5.82703,172043
566,saurabh9495,4,0.00233,10029,5.82936,172043
567,SeanPrashad,4,0.00233,10033,5.83168,172043
568,sgerme,4,0.00233,10037,5.83401,172043
569,shaunak-gupta,4,0.00233,10041,5.83633,172043
570,shock0572,4,0.00233,10045,5.83866,172043
571,shubhamyadav20,4,0.00233,10049,5.84098,172043
572,snipking,4,0.00233,10053,5.84331,172043
573,specxybeardo,4,0.00233,10057,5.84563,172043
574,sterjoski,4,0.00233,10061,5.84796,172043
575,stoneshi-yunify,4,0.00233,10065,5.85028,172043
576,styshoo,4,0.00233,10069,5.85261,172043
577,svua,4,0.00233,10073,5.85493,172043
578,swarnakl,4,0.00233,10077,5.85726,172043
579,Titof974,4,0.00233,10081,5.85958,172043
580,Titus-von-Koeller,4,0.00233,10085,5.86191,172043
581,typro33333,4,0.00233,10089,5.86423,172043
582,vardhanapoorv,4,0.00233,10093,5.86656,172043
583,vinayb21,4,0.00233,10097,5.86888,172043
584,vitalka200,4,0.00233,10101,5.87121,172043
585,vk2810,4,0.00233,10105,5.87353,172043
586,vramperez,4,0.00233,10109,5.87586,172043
587,waitstory,4,0.00233,10113,5.87818,172043
588,wenzdey,4,0.00233,10117,5.88051,172043
589,wiktor-k,4,0.00233,10121,5.88283,172043
590,YangLoveYing,4,0.00233,10125,5.88516,172043
591,yash0501,4,0.00233,10129,5.88748,172043
592,yj-yoo,4,0.00233,10133,5.88981,172043
593,zebulon99x,4,0.00233,10137,5.89213,172043
594,zejar,4,0.00233,10141,5.89446,172043
595,zwForrest,4,0.00233,10145,5.89678,172043
596,0xflotus,3,0.00174,10148,5.89853,172043
597,3scava1i3r,3,0.00174,10151,5.90027,172043
598,abel408,3,0.00174,10154,5.90201,172043
599,abhaygupta97,3,0.00174,10157,5.90376,172043
600,abhinavjha126,3,0.00174,10160,5.90550,172043
601,Abhishekguragol,3,0.00174,10163,5.90724,172043
602,adamoswick,3,0.00174,10166,5.90899,172043
603,addyess,3,0.00174,10169,5.91073,172043
604,ahammond,3,0.00174,10172,5.91248,172043
605,akshat62,3,0.00174,10175,5.91422,172043
606,akshitsarin,3,0.00174,10178,5.91596,172043
607,AlexWootton,3,0.00174,10181,5.91771,172043
608,angie1015,3,0.00174,10184,5.91945,172043
609,ankitkachru,3,0.00174,10187,5.92119,172043
610,Azenet,3,0.00174,10190,5.92294,172043
611,balakeshbalu,3,0.00174,10193,5.92468,172043
612,BaoTran91,3,0.00174,10196,5.92643,172043
613,bdols,3,0.00174,10199,5.92817,172043
614,berry120,3,0.00174,10202,5.92991,172043
615,bhops,3,0.00174,10205,5.93166,172043
616,blampe,3,0.00174,10208,5.93340,172043
617,buzzers,3,0.00174,10211,5.93514,172043
618,cbc02009,3,0.00174,10214,5.93689,172043
619,celiawa,3,0.00174,10217,5.93863,172043
620,chinglinwen,3,0.00174,10220,5.94038,172043
621,CiftciCagatay,3,0.00174,10223,5.94212,172043
622,cjohn001,3,0.00174,10226,5.94386,172043
623,CodeB9,3,0.00174,10229,5.94561,172043
624,codevbus,3,0.00174,10232,5.94735,172043
625,crazyscience,3,0.00174,10235,5.94909,172043
626,crunis,3,0.00174,10238,5.95084,172043
627,crweiner,3,0.00174,10241,5.95258,172043
628,ctromans,3,0.00174,10244,5.95433,172043
629,cumirror,3,0.00174,10247,5.95607,172043
630,daliborfilus,3,0.00174,10250,5.95781,172043
631,daniloff200,3,0.00174,10253,5.95956,172043
632,datacore-web,3,0.00174,10256,5.96130,172043
633,DavisLinDB,3,0.00174,10259,5.96304,172043
634,dbeezt,3,0.00174,10262,5.96479,172043
635,devrushit,3,0.00174,10265,5.96653,172043
636,ErroKokkarda,3,0.00174,10268,5.96828,172043
637,EvanPrivate,3,0.00174,10271,5.97002,172043
638,ferenc-hechler,3,0.00174,10274,5.97176,172043
639,feysalikbal,3,0.00174,10277,5.97351,172043
640,Furinkazan33,3,0.00174,10280,5.97525,172043
641,garuna-m6,3,0.00174,10283,5.97699,172043
642,geekboood,3,0.00174,10286,5.97874,172043
643,GTB3NW,3,0.00174,10289,5.98048,172043
644,guoard,3,0.00174,10292,5.98223,172043
645,hainesc,3,0.00174,10295,5.98397,172043
646,Hannessi,3,0.00174,10298,5.98571,172043
647,Hansyangxingxiang,3,0.00174,10301,5.98746,172043
648,HaykManukyanAvetiky,3,0.00174,10304,5.98920,172043
649,howardjones,3,0.00174,10307,5.99094,172043
650,howels,3,0.00174,10310,5.99269,172043
651,hrenard,3,0.00174,10313,5.99443,172043
652,huornlmj,3,0.00174,10316,5.99618,172043
653,iamkfred,3,0.00174,10319,5.99792,172043
654,igorkatz,3,0.00174,10322,5.99966,172043
655,indraneel-m,3,0.00174,10325,6.00141,172043
656,ItsJulian,3,0.00174,10328,6.00315,172043
657,jannispl,3,0.00174,10331,6.00489,172043
658,jaredkipe,3,0.00174,10334,6.00664,172043
659,jhuynh08,3,0.00174,10337,6.00838,172043
660,jilleJr,3,0.00174,10340,6.01013,172043
661,jishnujayakumar,3,0.00174,10343,6.01187,172043
662,joeldeteves,3,0.00174,10346,6.01361,172043
663,jordangarside,3,0.00174,10349,6.01536,172043
664,joseftschiggerlnts,3,0.00174,10352,6.01710,172043
665,kakaZhou719,3,0.00174,10355,6.01884,172043
666,karibertils,3,0.00174,10358,6.02059,172043
667,kaveman-,3,0.00174,10361,6.02233,172043
668,kic68,3,0.00174,10364,6.02408,172043
669,kira0204,3,0.00174,10367,6.02582,172043
670,kiwiroy,3,0.00174,10370,6.02756,172043
671,KKaras169169,3,0.00174,10373,6.02931,172043
672,kkarth1k,3,0.00174,10376,6.03105,172043
673,kvzn,3,0.00174,10379,6.03279,172043
674,l0010o0001l,3,0.00174,10382,6.03454,172043
675,LakshitF,3,0.00174,10385,6.03628,172043
676,lambda2,3,0.00174,10388,6.03803,172043
677,LiberiFatali,3,0.00174,10391,6.03977,172043
678,litaxc,3,0.00174,10394,6.04151,172043
679,lordk911,3,0.00174,10397,6.04326,172043
680,loxy,3,0.00174,10400,6.04500,172043
681,luginbash,3,0.00174,10403,6.04674,172043
682,lukasmetzner,3,0.00174,10406,6.04849,172043
683,maltegrosse,3,0.00174,10409,6.05023,172043
684,manjusm,3,0.00174,10412,6.05198,172043
685,marco-lia-blog,3,0.00174,10415,6.05372,172043
686,marcosinger,3,0.00174,10418,6.05546,172043
687,MarkCupitt,3,0.00174,10421,6.05721,172043
688,marthydavid,3,0.00174,10424,6.05895,172043
689,MattIPv4,3,0.00174,10427,6.06069,172043
690,maxs-rose,3,0.00174,10430,6.06244,172043
691,mbu147,3,0.00174,10433,6.06418,172043
692,mkosett,3,0.00174,10436,6.06593,172043
693,mkp13,3,0.00174,10439,6.06767,172043
694,Morzain,3,0.00174,10442,6.06941,172043
695,moshey1,3,0.00174,10445,6.07116,172043
696,mstrent,3,0.00174,10448,6.07290,172043
697,murkylife,3,0.00174,10451,6.07464,172043
698,mzur-hv,3,0.00174,10454,6.07639,172043
699,Nelias,3,0.00174,10457,6.07813,172043
700,nemaniarjun,3,0.00174,10460,6.07988,172043
701,NexZhu,3,0.00174,10463,6.08162,172043
702,nivedithapatil,3,0.00174,10466,6.08336,172043
703,nizmitz,3,0.00174,10469,6.08511,172043
704,nrusinko,3,0.00174,10472,6.08685,172043
705,NullOranje,3,0.00174,10475,6.08859,172043
706,Ochita,3,0.00174,10478,6.09034,172043
707,OPARA-PROSPER,3,0.00174,10481,6.09208,172043
708,orboan,3,0.00174,10484,6.09383,172043
709,pardhasm,3,0.00174,10487,6.09557,172043
710,ParthKulkarni,3,0.00174,10490,6.09731,172043
711,peuh,3,0.00174,10493,6.09906,172043
712,pleum,3,0.00174,10496,6.10080,172043
713,ppodolsky,3,0.00174,10499,6.10254,172043
714,proegssilb,3,0.00174,10502,6.10429,172043
715,PSTobiasMueller,3,0.00174,10505,6.10603,172043
716,puneet97,3,0.00174,10508,6.10778,172043
717,pushkyn,3,0.00174,10511,6.10952,172043
718,quadeare,3,0.00174,10514,6.11126,172043
719,quexten,3,0.00174,10517,6.11301,172043
720,rafael-rosseto,3,0.00174,10520,6.11475,172043
721,rahulbajaj0509,3,0.00174,10523,6.11649,172043
722,regain0001,3,0.00174,10526,6.11824,172043
723,rerime,3,0.00174,10529,6.11998,172043
724,rjsabatini,3,0.00174,10532,6.12173,172043
725,rkaranam,3,0.00174,10535,6.12347,172043
726,rneha725,3,0.00174,10538,6.12521,172043
727,robertfairhead,3,0.00174,10541,6.12696,172043
728,robjcaskey,3,0.00174,10544,6.12870,172043
729,RolandMa1986,3,0.00174,10547,6.13044,172043
730,rpieczon,3,0.00174,10550,6.13219,172043
731,rudbast,3,0.00174,10553,6.13393,172043
732,rudolfbyker,3,0.00174,10556,6.13568,172043
733,rvrvrv,3,0.00174,10559,6.13742,172043
734,rweilg,3,0.00174,10562,6.13916,172043
735,S4KH,3,0.00174,10565,6.14091,172043
736,sabbatum,3,0.00174,10568,6.14265,172043
737,sanke-t,3,0.00174,10571,6.14439,172043
738,saul-data,3,0.00174,10574,6.14614,172043
739,senthilkumar-e,3,0.00174,10577,6.14788,172043
740,shovanch,3,0.00174,10580,6.14963,172043
741,ShyamGit01,3,0.00174,10583,6.15137,172043
742,ShyamPraveenSingh,3,0.00174,10586,6.15311,172043
743,smahi,3,0.00174,10589,6.15486,172043
744,sohamsshah,3,0.00174,10592,6.15660,172043
745,sonam2905,3,0.00174,10595,6.15834,172043
746,soumyapanigrahi-k8s,3,0.00174,10598,6.16009,172043
747,StefanSa,3,0.00174,10601,6.16183,172043
748,stewbernetes,3,0.00174,10604,6.16358,172043
749,tahajahangir,3,0.00174,10607,6.16532,172043
750,tarelda,3,0.00174,10610,6.16706,172043
751,tayloreisman16,3,0.00174,10613,6.16881,172043
752,Techievena,3,0.00174,10616,6.17055,172043
753,TECHNOFAB11,3,0.00174,10619,6.17229,172043
754,teisena,3,0.00174,10622,6.17404,172043
755,TheEnbyperor,3,0.00174,10625,6.17578,172043
756,thehamdiaz,3,0.00174,10628,6.17753,172043
757,TheRealNoob,3,0.00174,10631,6.17927,172043
758,ThomasLohmann,3,0.00174,10634,6.18101,172043
759,toozdey,3,0.00174,10637,6.18276,172043
760,tothandor,3,0.00174,10640,6.18450,172043
761,tz-torchai,3,0.00174,10643,6.18624,172043
762,unnown,3,0.00174,10646,6.18799,172043
763,use-epoll,3,0.00174,10649,6.18973,172043
764,utkudarilmaz,3,0.00174,10652,6.19148,172043
765,victorr,3,0.00174,10655,6.19322,172043
766,V-Soni,3,0.00174,10658,6.19496,172043
767,weskiller,3,0.00174,10661,6.19671,172043
768,WillyRL,3,0.00174,10664,6.19845,172043
769,Xiryl,3,0.00174,10667,6.20019,172043
770,yamilurbina,3,0.00174,10670,6.20194,172043
771,yhkim-prestolabs,3,0.00174,10673,6.20368,172043
772,yo-ga,3,0.00174,10676,6.20543,172043
773,yydzhou,3,0.00174,10679,6.20717,172043
774,zabawaba99,3,0.00174,10682,6.20891,172043
775,zonk1,3,0.00174,10685,6.21066,172043
776,0dragosh,2,0.00116,10687,6.21182,172043
777,acceleratxr,2,0.00116,10689,6.21298,172043
778,aceat64,2,0.00116,10691,6.21414,172043
779,AdityaJ7,2,0.00116,10693,6.21531,172043
780,AFKD98,2,0.00116,10695,6.21647,172043
781,ahmedohadi,2,0.00116,10697,6.21763,172043
782,aland-zhang,2,0.00116,10699,6.21879,172043
783,Alex130469,2,0.00116,10701,6.21996,172043
784,allen-mlnx,2,0.00116,10703,6.22112,172043
785,amasolov,2,0.00116,10705,6.22228,172043
786,amishaCodes,2,0.00116,10707,6.22344,172043
787,Ankitkurani1997,2,0.00116,10709,6.22461,172043
788,antonblr,2,0.00116,10711,6.22577,172043
789,apatotski,2,0.00116,10713,6.22693,172043
790,archenroot,2,0.00116,10715,6.22809,172043
791,arn007,2,0.00116,10717,6.22926,172043
792,arusa,2,0.00116,10719,6.23042,172043
793,atheoscommune,2,0.00116,10721,6.23158,172043
794,AuqW9cQ,2,0.00116,10723,6.23274,172043
795,axlroden,2,0.00116,10725,6.23391,172043
796,bagerard,2,0.00116,10727,6.23507,172043
797,batarian71,2,0.00116,10729,6.23623,172043
798,bayeslearner,2,0.00116,10731,6.23739,172043
799,bdalpe,2,0.00116,10733,6.23856,172043
800,benda1997,2,0.00116,10735,6.23972,172043
801,beneiltis,2,0.00116,10737,6.24088,172043
802,bitfex,2,0.00116,10739,6.24204,172043
803,bmanojkumar,2,0.00116,10741,6.24321,172043
804,bnaigaonkar,2,0.00116,10743,6.24437,172043
805,Bonjunior,2,0.00116,10745,6.24553,172043
806,brentgroves,2,0.00116,10747,6.24669,172043
807,bspark8,2,0.00116,10749,6.24786,172043
808,busyboy77,2,0.00116,10751,6.24902,172043
809,cal101,2,0.00116,10753,6.25018,172043
810,cdjianghan,2,0.00116,10755,6.25134,172043
811,cfreksen,2,0.00116,10757,6.25251,172043
812,cglewis,2,0.00116,10759,6.25367,172043
813,ch1771dr0b0,2,0.00116,10761,6.25483,172043
814,CHANDAN2271,2,0.00116,10763,6.25599,172043
815,chetanyakan,2,0.00116,10765,6.25716,172043
816,clearhost-cmd,2,0.00116,10767,6.25832,172043
817,CloudFocused,2,0.00116,10769,6.25948,172043
818,cloudxabide,2,0.00116,10771,6.26064,172043
819,codeclassifiers,2,0.00116,10773,6.26181,172043
820,cowboysync,2,0.00116,10775,6.26297,172043
821,crod93,2,0.00116,10777,6.26413,172043
822,Cubixmeister,2,0.00116,10779,6.26529,172043
823,damlub,2,0.00116,10781,6.26646,172043
824,danishsamad,2,0.00116,10783,6.26762,172043
825,dapiaoke2021,2,0.00116,10785,6.26878,172043
826,datacore-peter,2,0.00116,10787,6.26994,172043
827,davidcodesido,2,0.00116,10789,6.27111,172043
828,daximillian,2,0.00116,10791,6.27227,172043
829,debisamal,2,0.00116,10793,6.27343,172043
830,deepak71,2,0.00116,10795,6.27459,172043
831,deepav16,2,0.00116,10797,6.27576,172043
832,Devivaralakshmi,2,0.00116,10799,6.27692,172043
833,devjyotipatra,2,0.00116,10801,6.27808,172043
834,devopstoday11,2,0.00116,10803,6.27924,172043
835,devshiva619,2,0.00116,10805,6.28041,172043
836,dharmendra-lingaiah,2,0.00116,10807,6.28157,172043
837,dhcn,2,0.00116,10809,6.28273,172043
838,dhruvikn,2,0.00116,10811,6.28389,172043
839,DiljyotS,2,0.00116,10813,6.28506,172043
840,doraemon-san,2,0.00116,10815,6.28622,172043
841,dpoison,2,0.00116,10817,6.28738,172043
842,Dreadnoth,2,0.00116,10819,6.28854,172043
843,druesendieb,2,0.00116,10821,6.28971,172043
844,dunefro,2,0.00116,10823,6.29087,172043
845,eculver,2,0.00116,10825,6.29203,172043
846,elamaran11,2,0.00116,10827,6.29319,172043
847,electricsrini,2,0.00116,10829,6.29436,172043
848,enzosk8,2,0.00116,10831,6.29552,172043
849,esimest,2,0.00116,10833,6.29668,172043
850,etlfg,2,0.00116,10835,6.29784,172043
851,ev4ern,2,0.00116,10837,6.29901,172043
852,everydots,2,0.00116,10839,6.30017,172043
853,fara-tode,2,0.00116,10841,6.30133,172043
854,Feniksss,2,0.00116,10843,6.30249,172043
855,fgimenezm,2,0.00116,10845,6.30366,172043
856,filippobosi,2,0.00116,10847,6.30482,172043
857,fmendez89,2,0.00116,10849,6.30598,172043
858,foldingbeauty,2,0.00116,10851,6.30714,172043
859,freym,2,0.00116,10853,6.30831,172043
860,FriedCircuits,2,0.00116,10855,6.30947,172043
861,garanews,2,0.00116,10857,6.31063,172043
862,gauravano,2,0.00116,10859,6.31179,172043
863,gfleury,2,0.00116,10861,6.31296,172043
864,gimstein,2,0.00116,10863,6.31412,172043
865,giridharshankar013,2,0.00116,10865,6.31528,172043
866,giusepperagusa,2,0.00116,10867,6.31644,172043
867,GubMid,2,0.00116,10869,6.31761,172043
868,halcyon,2,0.00116,10871,6.31877,172043
869,Halytskyi,2,0.00116,10873,6.31993,172043
870,hanieh-m,2,0.00116,10875,6.32109,172043
871,hansedong,2,0.00116,10877,6.32226,172043
872,happycoderincloud,2,0.00116,10879,6.32342,172043
873,hdnebat,2,0.00116,10881,6.32458,172043
874,hensur,2,0.00116,10883,6.32574,172043
875,hiteshsp,2,0.00116,10885,6.32691,172043
876,hrishike,2,0.00116,10887,6.32807,172043
877,hyt05,2,0.00116,10889,6.32923,172043
878,hyundw84,2,0.00116,10891,6.33039,172043
879,iamsivacheerla,2,0.00116,10893,6.33156,172043
880,iktucker,2,0.00116,10895,6.33272,172043
881,ileixe,2,0.00116,10897,6.33388,172043
882,inful,2,0.00116,10899,6.33504,172043
883,ishioni,2,0.00116,10901,6.33621,172043
884,ishuah,2,0.00116,10903,6.33737,172043
885,ismail0077,2,0.00116,10905,6.33853,172043
886,itaditya,2,0.00116,10907,6.33969,172043
887,IvanArjona,2,0.00116,10909,6.34086,172043
888,ivanfilippov,2,0.00116,10911,6.34202,172043
889,ivanix1,2,0.00116,10913,6.34318,172043
890,james-d-elliott,2,0.00116,10915,6.34434,172043
891,jameslave,2,0.00116,10917,6.34551,172043
892,jayrajput,2,0.00116,10919,6.34667,172043
893,JBaptisme33,2,0.00116,10921,6.34783,172043
894,jbrongtr,2,0.00116,10923,6.34899,172043
895,jennifer-kinsey,2,0.00116,10925,6.35016,172043
896,jnsrikanth,2,0.00116,10927,6.35132,172043
897,jnt2007,2,0.00116,10929,6.35248,172043
898,jp83,2,0.00116,10931,6.35364,172043
899,jphastings,2,0.00116,10933,6.35481,172043
900,JRobsonJr,2,0.00116,10935,6.35597,172043
901,justachetan,2,0.00116,10937,6.35713,172043
902,kaaass,2,0.00116,10939,6.35829,172043
903,kant777,2,0.00116,10941,6.35946,172043
904,kappa-wingman,2,0.00116,10943,6.36062,172043
905,karanssj4,2,0.00116,10945,6.36178,172043
906,kasimon,2,0.00116,10947,6.36294,172043
907,Kaushl2208,2,0.00116,10949,6.36411,172043
908,kenotsolutions,2,0.00116,10951,6.36527,172043
909,kevinzs2048,2,0.00116,10953,6.36643,172043
910,KhoaNPA,2,0.00116,10955,6.36759,172043
911,KiiLLzz78,2,0.00116,10957,6.36876,172043
912,kindrajeet,2,0.00116,10959,6.36992,172043
913,KirankumarAmbati,2,0.00116,10961,6.37108,172043
914,Klowner,2,0.00116,10963,6.37224,172043
915,knutole,2,0.00116,10965,6.37341,172043
916,kschzt,2,0.00116,10967,6.37457,172043
917,kshcherban,2,0.00116,10969,6.37573,172043
918,lazyIoad,2,0.00116,10971,6.37689,172043
919,Littlehhao,2,0.00116,10973,6.37806,172043
920,lleszczu,2,0.00116,10975,6.37922,172043
921,llhhbc,2,0.00116,10977,6.38038,172043
922,LorisSecuro,2,0.00116,10979,6.38154,172043
923,luharuka,2,0.00116,10981,6.38271,172043
924,luizcarlosfaria,2,0.00116,10983,6.38387,172043
925,malli31,2,0.00116,10985,6.38503,172043
926,marblerun,2,0.00116,10987,6.38619,172043
927,marcdejonge,2,0.00116,10989,6.38736,172043
928,margau,2,0.00116,10991,6.38852,172043
929,masihtehrani,2,0.00116,10993,6.38968,172043
930,MaskyS,2,0.00116,10995,6.39084,172043
931,matthew-williams,2,0.00116,10997,6.39201,172043
932,maximemoreillon,2,0.00116,10999,6.39317,172043
933,MayHuo,2,0.00116,11001,6.39433,172043
934,m-czarnik-exa,2,0.00116,11003,6.39549,172043
935,MdHanif01,2,0.00116,11005,6.39666,172043
936,michaeloreillyintel,2,0.00116,11007,6.39782,172043
937,MichaelSL,2,0.00116,11009,6.39898,172043
938,MichielCuijpers,2,0.00116,11011,6.40014,172043
939,mirceanton,2,0.00116,11013,6.40131,172043
940,mnavarrocarter,2,0.00116,11015,6.40247,172043
941,mnlipp,2,0.00116,11017,6.40363,172043
942,Mohkam,2,0.00116,11019,6.40479,172043
943,mohkoma,2,0.00116,11021,6.40596,172043
944,moogacs,2,0.00116,11023,6.40712,172043
945,mproniakin,2,0.00116,11025,6.40828,172043
946,mrmorais,2,0.00116,11027,6.40944,172043
947,mukhoakash,2,0.00116,11029,6.41061,172043
948,myzeprog,2,0.00116,11031,6.41177,172043
949,nawedx,2,0.00116,11033,6.41293,172043
950,ngbrown,2,0.00116,11035,6.41409,172043
951,nicolasbertaud,2,0.00116,11037,6.41526,172043
952,nidhiardent,2,0.00116,11039,6.41642,172043
953,Nisinghal,2,0.00116,11041,6.41758,172043
954,nnbaocuong99,2,0.00116,11043,6.41874,172043
955,noon2a,2,0.00116,11045,6.41991,172043
956,novasharper,2,0.00116,11047,6.42107,172043
957,nox,2,0.00116,11049,6.42223,172043
958,nullzone,2,0.00116,11051,6.42339,172043
959,nward,2,0.00116,11053,6.42456,172043
960,nxtstep,2,0.00116,11055,6.42572,172043
961,omarmakni,2,0.00116,11057,6.42688,172043
962,ozdemirburak,2,0.00116,11059,6.42804,172043
963,pascal71,2,0.00116,11061,6.42921,172043
964,pasindu94,2,0.00116,11063,6.43037,172043
965,payesanand,2,0.00116,11065,6.43153,172043
966,Pencerval,2,0.00116,11067,6.43269,172043
967,philippgille,2,0.00116,11069,6.43386,172043
968,philipphomberger,2,0.00116,11071,6.43502,172043
969,pik4ez,2,0.00116,11073,6.43618,172043
970,pingtotgp,2,0.00116,11075,6.43734,172043
971,pkavajin,2,0.00116,11077,6.43851,172043
972,plevart,2,0.00116,11079,6.43967,172043
973,Porama6400,2,0.00116,11081,6.44083,172043
974,port22,2,0.00116,11083,6.44199,172043
975,PowerYangcl,2,0.00116,11085,6.44316,172043
976,pranav-shah294,2,0.00116,11087,6.44432,172043
977,prashant0493,2,0.00116,11089,6.44548,172043
978,prashant0598,2,0.00116,11091,6.44664,172043
979,Privatecoder,2,0.00116,11093,6.44781,172043
980,rabadda,2,0.00116,11095,6.44897,172043
981,RajatArora08,2,0.00116,11097,6.45013,172043
982,RamIyer1998,2,0.00116,11099,6.45129,172043
983,rbg,2,0.00116,11101,6.45246,172043
984,rdegez,2,0.00116,11103,6.45362,172043
985,rgangoni,2,0.00116,11105,6.45478,172043
986,rhr323,2,0.00116,11107,6.45594,172043
987,riseofme,2,0.00116,11109,6.45711,172043
988,rohythakur,2,0.00116,11111,6.45827,172043
989,Roshanjossey,2,0.00116,11113,6.45943,172043
990,Sabarish41,2,0.00116,11115,6.46059,172043
991,sabzsystem,2,0.00116,11117,6.46176,172043
992,sakirma,2,0.00116,11119,6.46292,172043
993,salilhpe,2,0.00116,11121,6.46408,172043
994,salonigoyal2309,2,0.00116,11123,6.46524,172043
995,saltperfect,2,0.00116,11125,6.46641,172043
996,sam-2200,2,0.00116,11127,6.46757,172043
997,sandyjoshi,2,0.00116,11129,6.46873,172043
998,sanmai-NL,2,0.00116,11131,6.46989,172043
999,Sapp00,2,0.00116,11133,6.47106,172043
1000,saravanakumarrajendran,2,0.00116,11135,6.47222,172043
1001,sarayourfriend,2,0.00116,11137,6.47338,172043
1002,saumya1906,2,0.00116,11139,6.47454,172043
1003,scorphus,2,0.00116,11141,6.47571,172043
1004,sebadob,2,0.00116,11143,6.47687,172043
1005,seungwoo-lee-518-at-proton-me,2,0.00116,11145,6.47803,172043
1006,sherif-fanous,2,0.00116,11147,6.47919,172043
1007,shinypenny31,2,0.00116,11149,6.48036,172043
1008,Shishuii,2,0.00116,11151,6.48152,172043
1009,shivani-1521,2,0.00116,11153,6.48268,172043
1010,shivg7706,2,0.00116,11155,6.48384,172043
1011,singaravelanaws,2,0.00116,11157,6.48501,172043
1012,Smithx10,2,0.00116,11159,6.48617,172043
1013,SoftCreatR,2,0.00116,11161,6.48733,172043
1014,Soltaniant,2,0.00116,11163,6.48849,172043
1015,soulwhisper,2,0.00116,11165,6.48966,172043
1016,srivastavaayu,2,0.00116,11167,6.49082,172043
1017,sroskelley,2,0.00116,11169,6.49198,172043
1018,sstubbs,2,0.00116,11171,6.49314,172043
1019,StanForever,2,0.00116,11173,6.49431,172043
1020,stefanfritsch,2,0.00116,11175,6.49547,172043
1021,StephenOrJames,2,0.00116,11177,6.49663,172043
1022,subeshf,2,0.00116,11179,6.49779,172043
1023,sudhinm,2,0.00116,11181,6.49896,172043
1024,sudonitesh,2,0.00116,11183,6.50012,172043
1025,sunnyPike,2,0.00116,11185,6.50128,172043
1026,surajkumarr12,2,0.00116,11187,6.50244,172043
1027,Surajv311,2,0.00116,11189,6.50361,172043
1028,swatisingh45,2,0.00116,11191,6.50477,172043
1029,taozix,2,0.00116,11193,6.50593,172043
1030,TechSpiritSS,2,0.00116,11195,6.50709,172043
1031,TheNakedZealot,2,0.00116,11197,6.50826,172043
1032,theragnarpatel,2,0.00116,11199,6.50942,172043
1033,tjmchenry,2,0.00116,11201,6.51058,172043
1034,tlentali,2,0.00116,11203,6.51174,172043
1035,tmvfb,2,0.00116,11205,6.51291,172043
1036,TomMD,2,0.00116,11207,6.51407,172043
1037,TomYork1986,2,0.00116,11209,6.51523,172043
1038,tux-00,2,0.00116,11211,6.51639,172043
1039,twx462199,2,0.00116,11213,6.51756,172043
1040,uhlhosting,2,0.00116,11215,6.51872,172043
1041,Vaishnavi1411,2,0.00116,11217,6.51988,172043
1042,valkolaci,2,0.00116,11219,6.52104,172043
1043,vsandin-nr,2,0.00116,11221,6.52221,172043
1044,w4,2,0.00116,11223,6.52337,172043
1045,wantdrink,2,0.00116,11225,6.52453,172043
1046,wilf1rst,2,0.00116,11227,6.52569,172043
1047,woloss,2,0.00116,11229,6.52686,172043
1048,wrtabhi611,2,0.00116,11231,6.52802,172043
1049,wzx479,2,0.00116,11233,6.52918,172043
1050,xpowerman,2,0.00116,11235,6.53034,172043
1051,yashchoudhary8955,2,0.00116,11237,6.53151,172043
1052,Yash-Garg,2,0.00116,11239,6.53267,172043
1053,yeshwanthc,2,0.00116,11241,6.53383,172043
1054,ymwang7,2,0.00116,11243,6.53499,172043
1055,yuvrajsingh79,2,0.00116,11245,6.53616,172043
1056,zach-robinson,2,0.00116,11247,6.53732,172043
1057,zadunn,2,0.00116,11249,6.53848,172043
1058,zerowebcorp,2,0.00116,11251,6.53964,172043
1059,zhangdeshuai1999,2,0.00116,11253,6.54081,172043
1060,zlen1313,2,0.00116,11255,6.54197,172043
1061,007akk,1,0.00058,11256,6.54255,172043
1062,007thecoder,1,0.00058,11257,6.54313,172043
1063,1lann,1,0.00058,11258,6.54371,172043
1064,3bbbeau,1,0.00058,11259,6.54429,172043
1065,94151,1,0.00058,11260,6.54488,172043
1066,a2hksy,1,0.00058,11261,6.54546,172043
1067,aaahrens,1,0.00058,11262,6.54604,172043
1068,abzenenet,1,0.00058,11263,6.54662,172043
1069,achichenin,1,0.00058,11264,6.54720,172043
1070,achoosv,1,0.00058,11265,6.54778,172043
1071,adimessi,1,0.00058,11266,6.54836,172043
1072,aecio,1,0.00058,11267,6.54894,172043
1073,AEGEGE,1,0.00058,11268,6.54953,172043
1074,agilob,1,0.00058,11269,6.55011,172043
1075,Aguay-val,1,0.00058,11270,6.55069,172043
1076,AichaDevOps,1,0.00058,11271,6.55127,172043
1077,aidapsibr,1,0.00058,11272,6.55185,172043
1078,aisangelos,1,0.00058,11273,6.55243,172043
1079,aivoyager8,1,0.00058,11274,6.55301,172043
1080,ajesusflores,1,0.00058,11275,6.55359,172043
1081,akulpillai,1,0.00058,11276,6.55418,172043
1082,al8ba,1,0.00058,11277,6.55476,172043
1083,albertkohl-monotek,1,0.00058,11278,6.55534,172043
1084,Alceatraz,1,0.00058,11279,6.55592,172043
1085,AleksandrSor,1,0.00058,11280,6.55650,172043
1086,aleksasiriski,1,0.00058,11281,6.55708,172043
1087,alexanderzimmer,1,0.00058,11282,6.55766,172043
1088,alexandraveres7,1,0.00058,11283,6.55824,172043
1089,alexjmbarton,1,0.00058,11284,6.55883,172043
1090,allensiho,1,0.00058,11285,6.55941,172043
1091,alonsocamaro,1,0.00058,11286,6.55999,172043
1092,AmazingPangWei,1,0.00058,11287,6.56057,172043
1093,ananya-code,1,0.00058,11288,6.56115,172043
1094,andrea-zanetti,1,0.00058,11289,6.56173,172043
1095,AndreiCojocaru96,1,0.00058,11290,6.56231,172043
1096,andrey-podko,1,0.00058,11291,6.56289,172043
1097,angarod,1,0.00058,11292,6.56348,172043
1098,Aniket1923,1,0.00058,11293,6.56406,172043
1099,aniket2098,1,0.00058,11294,6.56464,172043
1100,ankur-gupta-guavus,1,0.00058,11295,6.56522,172043
1101,anthosz,1,0.00058,11296,6.56580,172043
1102,apr1809,1,0.00058,11297,6.56638,172043
1103,AraanBranco,1,0.00058,11298,6.56696,172043
1104,aravindgopall,1,0.00058,11299,6.56754,172043
1105,arghyaiitb,1,0.00058,11300,6.56813,172043
1106,artdevjs,1,0.00058,11301,6.56871,172043
1107,artem-zinnatullin,1,0.00058,11302,6.56929,172043
1108,arunsathiya,1,0.00058,11303,6.56987,172043
1109,arylwen,1,0.00058,11304,6.57045,172043
1110,ashubly25,1,0.00058,11305,6.57103,172043
1111,asjg-study,1,0.00058,11306,6.57161,172043
1112,askalik,1,0.00058,11307,6.57219,172043
1113,Astha2111,1,0.00058,11308,6.57278,172043
1114,ATalkingHead,1,0.00058,11309,6.57336,172043
1115,Athulpai12,1,0.00058,11310,6.57394,172043
1116,au2001,1,0.00058,11311,6.57452,172043
1117,avinashdhinwa,1,0.00058,11312,6.57510,172043
1118,avirlrma,1,0.00058,11313,6.57568,172043
1119,ayush987goyal,1,0.00058,11314,6.57626,172043
1120,baboune,1,0.00058,11315,6.57684,172043
1121,barthr,1,0.00058,11316,6.57743,172043
1122,basavaraj134,1,0.00058,11317,6.57801,172043
1123,baskinsy,1,0.00058,11318,6.57859,172043
1124,baymaxlan,1,0.00058,11319,6.57917,172043
1125,bbockelm,1,0.00058,11320,6.57975,172043
1126,bdchauvette,1,0.00058,11321,6.58033,172043
1127,BegoneRaven,1,0.00058,11322,6.58091,172043
1128,Beheadedstraw,1,0.00058,11323,6.58149,172043
1129,berviantoleo,1,0.00058,11324,6.58208,172043
1130,bfreuden,1,0.00058,11325,6.58266,172043
1131,bhavyashre,1,0.00058,11326,6.58324,172043
1132,bhuvi1114,1,0.00058,11327,6.58382,172043
1133,bianchi2,1,0.00058,11328,6.58440,172043
1134,bindumadhuri89,1,0.00058,11329,6.58498,172043
1135,bjetal,1,0.00058,11330,6.58556,172043
1136,boxofcrates,1,0.00058,11331,6.58614,172043
1137,brandy,1,0.00058,11332,6.58673,172043
1138,bruceg,1,0.00058,11333,6.58731,172043
1139,bugslifesolutions,1,0.00058,11334,6.58789,172043
1140,burhandodhy,1,0.00058,11335,6.58847,172043
1141,bwolf,1,0.00058,11336,6.58905,172043
1142,caiconkhicon,1,0.00058,11337,6.58963,172043
1143,caseyjmorton,1,0.00058,11338,6.59021,172043
1144,cchanning,1,0.00058,11339,6.59079,172043
1145,ccww552017,1,0.00058,11340,6.59138,172043
1146,c-dev-acc1,1,0.00058,11341,6.59196,172043
1147,cdsl1963,1,0.00058,11342,6.59254,172043
1148,centromere,1,0.00058,11343,6.59312,172043
1149,cfilby,1,0.00058,11344,6.59370,172043
1150,cf-sewe,1,0.00058,11345,6.59428,172043
1151,chandanpasunoori,1,0.00058,11346,6.59486,172043
1152,chase1124,1,0.00058,11347,6.59544,172043
1153,ChetanAtrawalkarCA,1,0.00058,11348,6.59603,172043
1154,chinmayaSBhat,1,0.00058,11349,6.59661,172043
1155,choilmto,1,0.00058,11350,6.59719,172043
1156,choyuansu,1,0.00058,11351,6.59777,172043
1157,chris199512,1,0.00058,11352,6.59835,172043
1158,Chrisys93,1,0.00058,11353,6.59893,172043
1159,chtardif,1,0.00058,11354,6.59951,172043
1160,civts,1,0.00058,11355,6.60009,172043
1161,Clarkkent69,1,0.00058,11356,6.60068,172043
1162,clemric,1,0.00058,11357,6.60126,172043
1163,cm7799,1,0.00058,11358,6.60184,172043
1164,cnut,1,0.00058,11359,6.60242,172043
1165,codeonix,1,0.00058,11360,6.60300,172043
1166,CornWorld,1,0.00058,11361,6.60358,172043
1167,csnktms,1,0.00058,11362,6.60416,172043
1168,csnyder616,1,0.00058,11363,6.60474,172043
1169,cswaas,1,0.00058,11364,6.60533,172043
1170,dabaoonline,1,0.00058,11365,6.60591,172043
1171,dacosta89,1,0.00058,11366,6.60649,172043
1172,danjenkins,1,0.00058,11367,6.60707,172043
1173,darias1986,1,0.00058,11368,6.60765,172043
1174,darioneto,1,0.00058,11369,6.60823,172043
1175,DArtagan,1,0.00058,11370,6.60881,172043
1176,datacore-phandigund,1,0.00058,11371,6.60939,172043
1177,daveloyall,1,0.00058,11372,6.60998,172043
1178,davidnewhall,1,0.00058,11373,6.61056,172043
1179,dbhd,1,0.00058,11374,6.61114,172043
1180,ddal,1,0.00058,11375,6.61172,172043
1181,dedeira,1,0.00058,11376,6.61230,172043
1182,deepakgl,1,0.00058,11377,6.61288,172043
1183,DellanX,1,0.00058,11378,6.61346,172043
1184,dever4eg,1,0.00058,11379,6.61404,172043
1185,Deveshs23,1,0.00058,11380,6.61463,172043
1186,devopsawy,1,0.00058,11381,6.61521,172043
1187,Dipanshu-Sehjal,1,0.00058,11382,6.61579,172043
1188,divya144,1,0.00058,11383,6.61637,172043
1189,DivyanshuSaxena,1,0.00058,11384,6.61695,172043
1190,divyhshah,1,0.00058,11385,6.61753,172043
1191,dixonqin,1,0.00058,11386,6.61811,172043
1192,dizzy1021,1,0.00058,11387,6.61869,172043
1193,djkoloski,1,0.00058,11388,6.61928,172043
1194,DMajrekar,1,0.00058,11389,6.61986,172043
1195,dongsupkim-onepredict,1,0.00058,11390,6.62044,172043
1196,Doosty,1,0.00058,11391,6.62102,172043
1197,dostalradim,1,0.00058,11392,6.62160,172043
1198,dotslash21,1,0.00058,11393,6.62218,172043
1199,dstathos,1,0.00058,11394,6.62276,172043
1200,duclm2609,1,0.00058,11395,6.62334,172043
1201,duongmn89,1,0.00058,11396,6.62393,172043
1202,ekarak,1,0.00058,11397,6.62451,172043
1203,elangovanshanthi,1,0.00058,11398,6.62509,172043
1204,elg0ch0,1,0.00058,11399,6.62567,172043
1205,EpiqSty,1,0.00058,11400,6.62625,172043
1206,ergleb78,1,0.00058,11401,6.62683,172043
1207,eslap,1,0.00058,11402,6.62741,172043
1208,ESonata,1,0.00058,11403,6.62799,172043
1209,etherealvisage,1,0.00058,11404,6.62858,172043
1210,everflux,1,0.00058,11405,6.62916,172043
1211,evertmulder,1,0.00058,11406,6.62974,172043
1212,evgeniwk,1,0.00058,11407,6.63032,172043
1213,f5-jay,1,0.00058,11408,6.63090,172043
1214,FelipeRosa,1,0.00058,11409,6.63148,172043
1215,feranwq,1,0.00058,11410,6.63206,172043
1216,ferhatguneri,1,0.00058,11411,6.63264,172043
1217,Fersoil,1,0.00058,11412,6.63323,172043
1218,filip-lebiecki,1,0.00058,11413,6.63381,172043
1219,fimmicon,1,0.00058,11414,6.63439,172043
1220,Firaenix,1,0.00058,11415,6.63497,172043
1221,fixed77,1,0.00058,11416,6.63555,172043
1222,fleshin,1,0.00058,11417,6.63613,172043
1223,flowkraD,1,0.00058,11418,6.63671,172043
1224,fornof,1,0.00058,11419,6.63729,172043
1225,FridayRU,1,0.00058,11420,6.63788,172043
1226,furynick,1,0.00058,11421,6.63846,172043
1227,fyang13,1,0.00058,11422,6.63904,172043
1228,gabrielcalderon,1,0.00058,11423,6.63962,172043
1229,gagandeepp,1,0.00058,11424,6.64020,172043
1230,galindroasml,1,0.00058,11425,6.64078,172043
1231,ganey,1,0.00058,11426,6.64136,172043
1232,GanweiYee,1,0.00058,11427,6.64194,172043
1233,gargeesuresh,1,0.00058,11428,6.64253,172043
1234,garypen,1,0.00058,11429,6.64311,172043
1235,GBBx,1,0.00058,11430,6.64369,172043
1236,gilmararaujo,1,0.00058,11431,6.64427,172043
1237,ginn13,1,0.00058,11432,6.64485,172043
1238,glatteis,1,0.00058,11433,6.64543,172043
1239,gr33ngiant112,1,0.00058,11434,6.64601,172043
1240,grouchojeff,1,0.00058,11435,6.64659,172043
1241,grubjack,1,0.00058,11436,6.64718,172043
1242,Guigouu,1,0.00058,11437,6.64776,172043
1243,gutsytechster,1,0.00058,11438,6.64834,172043
1244,haijeploeg,1,0.00058,11439,6.64892,172043
1245,hansh0801,1,0.00058,11440,6.64950,172043
1246,harikrishnajiju,1,0.00058,11441,6.65008,172043
1247,hariomshandilya,1,0.00058,11442,6.65066,172043
1248,HarshalGoyal,1,0.00058,11443,6.65124,172043
1249,Harshmeets007,1,0.00058,11444,6.65183,172043
1250,harshtheworkman,1,0.00058,11445,6.65241,172043
1251,helixnebula24,1,0.00058,11446,6.65299,172043
1252,HenningCash,1,0.00058,11447,6.65357,172043
1253,HenryGP,1,0.00058,11448,6.65415,172043
1254,hergi2004,1,0.00058,11449,6.65473,172043
1255,H-haonan,1,0.00058,11450,6.65531,172043
1256,hilbertglm,1,0.00058,11451,6.65589,172043
1257,holoGDM,1,0.00058,11452,6.65648,172043
1258,homuncculus,1,0.00058,11453,6.65706,172043
1259,Hr46ph,1,0.00058,11454,6.65764,172043
1260,Hu-nie,1,0.00058,11455,6.65822,172043
1261,hussaino,1,0.00058,11456,6.65880,172043
1262,hznor,1,0.00058,11457,6.65938,172043
1263,IceeMC,1,0.00058,11458,6.65996,172043
1264,iceman91176,1,0.00058,11459,6.66054,172043
1265,ifalex,1,0.00058,11460,6.66113,172043
1266,IgnasA,1,0.00058,11461,6.66171,172043
1267,igorabiola,1,0.00058,11462,6.66229,172043
1268,ikaustubhk,1,0.00058,11463,6.66287,172043
1269,immens,1,0.00058,11464,6.66345,172043
1270,indranarayan12,1,0.00058,11465,6.66403,172043
1271,ion1,1,0.00058,11466,6.66461,172043
1272,iswbm,1,0.00058,11467,6.66519,172043
1273,itsmesinghavneet,1,0.00058,11468,6.66578,172043
1274,jackmurray,1,0.00058,11469,6.66636,172043
1275,jackpot51,1,0.00058,11470,6.66694,172043
1276,jacquelotjeff,1,0.00058,11471,6.66752,172043
1277,jagyas,1,0.00058,11472,6.66810,172043
1278,jainsaarthak,1,0.00058,11473,6.66868,172043
1279,jamesa,1,0.00058,11474,6.66926,172043
1280,James-N-M,1,0.00058,11475,6.66984,172043
1281,jamesread,1,0.00058,11476,6.67043,172043
1282,jam-re,1,0.00058,11477,6.67101,172043
1283,JannikZed,1,0.00058,11478,6.67159,172043
1284,jaschaio,1,0.00058,11479,6.67217,172043
1285,jatanmalde,1,0.00058,11480,6.67275,172043
1286,javagarm,1,0.00058,11481,6.67333,172043
1287,jayeshmann,1,0.00058,11482,6.67391,172043
1288,jaykhengar,1,0.00058,11483,6.67449,172043
1289,jay-wilson,1,0.00058,11484,6.67508,172043
1290,jbampton,1,0.00058,11485,6.67566,172043
1291,jcalvilloitrs,1,0.00058,11486,6.67624,172043
1292,jdevries3133,1,0.00058,11487,6.67682,172043
1293,jdkramhoft,1,0.00058,11488,6.67740,172043
1294,jeffguorg,1,0.00058,11489,6.67798,172043
1295,jfugate11377,1,0.00058,11490,6.67856,172043
1296,jguerreroyb,1,0.00058,11491,6.67914,172043
1297,jhinch,1,0.00058,11492,6.67973,172043
1298,jiangxiaobai,1,0.00058,11493,6.68031,172043
1299,jixiang8320216,1,0.00058,11494,6.68089,172043
1300,jj1682000,1,0.00058,11495,6.68147,172043
1301,jjbubudi,1,0.00058,11496,6.68205,172043
1302,JoelJJoseph,1,0.00058,11497,6.68263,172043
1303,joergkiesewetter,1,0.00058,11498,6.68321,172043
1304,Joffref,1,0.00058,11499,6.68379,172043
1305,john-deng,1,0.00058,11500,6.68438,172043
1306,John-E-Doe,1,0.00058,11501,6.68496,172043
1307,johnpanos,1,0.00058,11502,6.68554,172043
1308,johnson-earls,1,0.00058,11503,6.68612,172043
1309,jomar83,1,0.00058,11504,6.68670,172043
1310,Jonathan-Eid,1,0.00058,11505,6.68728,172043
1311,joonas-fi,1,0.00058,11506,6.68786,172043
1312,JordanDeBeer,1,0.00058,11507,6.68844,172043
1313,joy2323,1,0.00058,11508,6.68903,172043
1314,jpdilan,1,0.00058,11509,6.68961,172043
1315,jpecora716,1,0.00058,11510,6.69019,172043
1316,jrote1,1,0.00058,11511,6.69077,172043
1317,jrx-sjg,1,0.00058,11512,6.69135,172043
1318,justinpriya,1,0.00058,11513,6.69193,172043
1319,juwalter,1,0.00058,11514,6.69251,172043
1320,kadaffy,1,0.00058,11515,6.69309,172043
1321,kalyantt,1,0.00058,11516,6.69368,172043
1322,kambojshalabh35,1,0.00058,11517,6.69426,172043
1323,Kanav-7,1,0.00058,11518,6.69484,172043
1324,kanubhav906,1,0.00058,11519,6.69542,172043
1325,KarenEfereyan,1,0.00058,11520,6.69600,172043
1326,kashish2909,1,0.00058,11521,6.69658,172043
1327,Kashyap85,1,0.00058,11522,6.69716,172043
1328,kasim457,1,0.00058,11523,6.69774,172043
1329,kecece,1,0.00058,11524,6.69833,172043
1330,kellyhair,1,0.00058,11525,6.69891,172043
1331,ken-tunc,1,0.00058,11526,6.69949,172043
1332,khanhngobackend,1,0.00058,11527,6.70007,172043
1333,khemarachuon,1,0.00058,11528,6.70065,172043
1334,KhojiZoda,1,0.00058,11529,6.70123,172043
1335,kiltum,1,0.00058,11530,6.70181,172043
1336,kinetickansra,1,0.00058,11531,6.70239,172043
1337,kingmorning,1,0.00058,11532,6.70298,172043
1338,klebervirgilio,1,0.00058,11533,6.70356,172043
1339,kmpartner,1,0.00058,11534,6.70414,172043
1340,kojole,1,0.00058,11535,6.70472,172043
1341,kp01aj,1,0.00058,11536,6.70530,172043
1342,kpearson,1,0.00058,11537,6.70588,172043
1343,krishnakarthik9,1,0.00058,11538,6.70646,172043
1344,Krutonium,1,0.00058,11539,6.70704,172043
1345,ksyblast,1,0.00058,11540,6.70763,172043
1346,kuja53,1,0.00058,11541,6.70821,172043
1347,kumar-mayadata,1,0.00058,11542,6.70879,172043
1348,kumar-shantanu,1,0.00058,11543,6.70937,172043
1349,kunal2604,1,0.00058,11544,6.70995,172043
1350,labdidi,1,0.00058,11545,6.71053,172043
1351,laingke,1,0.00058,11546,6.71111,172043
1352,landinged,1,0.00058,11547,6.71169,172043
1353,Langhalsdino,1,0.00058,11548,6.71228,172043
1354,Lavish-Garg,1,0.00058,11549,6.71286,172043
1355,lcaflc,1,0.00058,11550,6.71344,172043
1356,leleobhz,1,0.00058,11551,6.71402,172043
1357,lenko-d,1,0.00058,11552,6.71460,172043
1358,LennertMertens,1,0.00058,11553,6.71518,172043
1359,letajmal,1,0.00058,11554,6.71576,172043
1360,Lewisjmp,1,0.00058,11555,6.71634,172043
1361,lfillmore,1,0.00058,11556,6.71693,172043
1362,liangchao88,1,0.00058,11557,6.71751,172043
1363,liasica,1,0.00058,11558,6.71809,172043
1364,lichensky,1,0.00058,11559,6.71867,172043
1365,linkinghack,1,0.00058,11560,6.71925,172043
1366,linonetwo,1,0.00058,11561,6.71983,172043
1367,Lin-to-John,1,0.00058,11562,6.72041,172043
1368,liuziyuan,1,0.00058,11563,6.72099,172043
1369,liyuntang,1,0.00058,11564,6.72158,172043
1370,logi85,1,0.00058,11565,6.72216,172043
1371,looking-for-my-magic-bean,1,0.00058,11566,6.72274,172043
1372,lord-kyron,1,0.00058,11567,6.72332,172043
1373,loren-osborn,1,0.00058,11568,6.72390,172043
1374,l-ra,1,0.00058,11569,6.72448,172043
1375,luis-guimaraes-exoawk,1,0.00058,11570,6.72506,172043
1376,lukasbalaz,1,0.00058,11571,6.72564,172043
1377,LukasKnuth,1,0.00058,11572,6.72623,172043
1378,luks,1,0.00058,11573,6.72681,172043
1379,maagy,1,0.00058,11574,6.72739,172043
1380,MABIY,1,0.00058,11575,6.72797,172043
1381,madhavi007,1,0.00058,11576,6.72855,172043
1382,magnetised,1,0.00058,11577,6.72913,172043
1383,maheshreddyuma,1,0.00058,11578,6.72971,172043
1384,malgamves,1,0.00058,11579,6.73029,172043
1385,manaswinidas,1,0.00058,11580,6.73088,172043
1386,mando222,1,0.00058,11581,6.73146,172043
1387,manojlds,1,0.00058,11582,6.73204,172043
1388,manosoft,1,0.00058,11583,6.73262,172043
1389,manpreetrathore,1,0.00058,11584,6.73320,172043
1390,marceloabk,1,0.00058,11585,6.73378,172043
1391,marci010101,1,0.00058,11586,6.73436,172043
1392,marcolongol,1,0.00058,11587,6.73494,172043
1393,markqiu,1,0.00058,11588,6.73553,172043
1394,matthewei,1,0.00058,11589,6.73611,172043
1395,mattmeye,1,0.00058,11590,6.73669,172043
1396,maxnrb,1,0.00058,11591,6.73727,172043
1397,mayadata-github,1,0.00058,11592,6.73785,172043
1398,mayhewj,1,0.00058,11593,6.73843,172043
1399,mb7079,1,0.00058,11594,6.73901,172043
1400,MBcom,1,0.00058,11595,6.73959,172043
1401,mchan-b,1,0.00058,11596,6.74018,172043
1402,meise,1,0.00058,11597,6.74076,172043
1403,mengsuenyan,1,0.00058,11598,6.74134,172043
1404,metbog,1,0.00058,11599,6.74192,172043
1405,metsuke0,1,0.00058,11600,6.74250,172043
1406,mgrechukh,1,0.00058,11601,6.74308,172043
1407,michaeleino,1,0.00058,11602,6.74366,172043
1408,michalzxc,1,0.00058,11603,6.74424,172043
1409,miragecentury,1,0.00058,11604,6.74483,172043
1410,misteruly,1,0.00058,11605,6.74541,172043
1411,mjsjinsu,1,0.00058,11606,6.74599,172043
1412,mkenguva,1,0.00058,11607,6.74657,172043
1413,mkm29,1,0.00058,11608,6.74715,172043
1414,mkp7,1,0.00058,11609,6.74773,172043
1415,mmelyp,1,0.00058,11610,6.74831,172043
1416,moritz31,1,0.00058,11611,6.74889,172043
1417,mounikec,1,0.00058,11612,6.74948,172043
1418,mrvnklm,1,0.00058,11613,6.75006,172043
1419,Mrwu87,1,0.00058,11614,6.75064,172043
1420,mr-yamraj,1,0.00058,11615,6.75122,172043
1421,mspyder,1,0.00058,11616,6.75180,172043
1422,mukundmckinsey,1,0.00058,11617,6.75238,172043
1423,MWWQFSPG,1,0.00058,11618,6.75296,172043
1424,mycryptonite,1,0.00058,11619,6.75354,172043
1425,nahsi,1,0.00058,11620,6.75413,172043
1426,NajmudheenCT,1,0.00058,11621,6.75471,172043
1427,Naman-Bhalla,1,0.00058,11622,6.75529,172043
1428,ncrmro,1,0.00058,11623,6.75587,172043
1429,nd2014-public,1,0.00058,11624,6.75645,172043
1430,nderraugh,1,0.00058,11625,6.75703,172043
1431,neilnaveen,1,0.00058,11626,6.75761,172043
1432,nelboudjay,1,0.00058,11627,6.75819,172043
1433,nemmeviu,1,0.00058,11628,6.75878,172043
1434,nevosial,1,0.00058,11629,6.75936,172043
1435,ng29,1,0.00058,11630,6.75994,172043
1436,nheinemans-asml,1,0.00058,11631,6.76052,172043
1437,Nihao123451,1,0.00058,11632,6.76110,172043
1438,nikhil-bhat,1,0.00058,11633,6.76168,172043
1439,nikita812,1,0.00058,11634,6.76226,172043
1440,NilanshGupta,1,0.00058,11635,6.76284,172043
1441,nimesh70,1,0.00058,11636,6.76343,172043
1442,NinekoTheCat,1,0.00058,11637,6.76401,172043
1443,Nivedita967,1,0.00058,11638,6.76459,172043
1444,npcxiao,1,0.00058,11639,6.76517,172043
1445,ntdt,1,0.00058,11640,6.76575,172043
1446,Nurza,1,0.00058,11641,6.76633,172043
1447,nvoskuilen,1,0.00058,11642,6.76691,172043
1448,nzbart,1,0.00058,11643,6.76749,172043
1449,OBAA,1,0.00058,11644,6.76808,172043
1450,olivibernard,1,0.00058,11645,6.76866,172043
1451,omitrowski,1,0.00058,11646,6.76924,172043
1452,oscar-martin,1,0.00058,11647,6.76982,172043
1453,oyakhilomee,1,0.00058,11648,6.77040,172043
1454,pachecux,1,0.00058,11649,6.77098,172043
1455,palash9561,1,0.00058,11650,6.77156,172043
1456,paribeshdangal66,1,0.00058,11651,6.77214,172043
1457,Parikshit-Hooda,1,0.00058,11652,6.77273,172043
1458,parthpandyappp,1,0.00058,11653,6.77331,172043
1459,parulagg27,1,0.00058,11654,6.77389,172043
1460,pathanzafar702,1,0.00058,11655,6.77447,172043
1461,patrickstrick,1,0.00058,11656,6.77505,172043
1462,paulfermoreyes,1,0.00058,11657,6.77563,172043
1463,PaulRusuTibreanu,1,0.00058,11658,6.77621,172043
1464,pavankumarkatakam,1,0.00058,11659,6.77679,172043
1465,phiilu,1,0.00058,11660,6.77738,172043
1466,PhilippHeuer,1,0.00058,11661,6.77796,172043
1467,Physsix27,1,0.00058,11662,6.77854,172043
1468,pkaminsk,1,0.00058,11663,6.77912,172043
1469,pokerstarxy,1,0.00058,11664,6.77970,172043
1470,porjo,1,0.00058,11665,6.78028,172043
1471,Prasoon1993,1,0.00058,11666,6.78086,172043
1472,pratyush047,1,0.00058,11667,6.78144,172043
1473,priyanshu5474,1,0.00058,11668,6.78203,172043
1474,priyeshwalunj,1,0.00058,11669,6.78261,172043
1475,prog1dev,1,0.00058,11670,6.78319,172043
1476,psi-4ward,1,0.00058,11671,6.78377,172043
1477,pukanszkypeter,1,0.00058,11672,6.78435,172043
1478,PululuK,1,0.00058,11673,6.78493,172043
1479,pushparavi123,1,0.00058,11674,6.78551,172043
1480,pzoxiuv,1,0.00058,11675,6.78609,172043
1481,qiuwenxiang,1,0.00058,11676,6.78668,172043
1482,qmnonic,1,0.00058,11677,6.78726,172043
1483,radtraveller1,1,0.00058,11678,6.78784,172043
1484,rafaa1994,1,0.00058,11679,6.78842,172043
1485,raihan71,1,0.00058,11680,6.78900,172043
1486,rajali,1,0.00058,11681,6.78958,172043
1487,rajeshgangoni,1,0.00058,11682,6.79016,172043
1488,rajeshvijayarajan,1,0.00058,11683,6.79074,172043
1489,Raman-Kumar,1,0.00058,11684,6.79133,172043
1490,RamKrish2079,1,0.00058,11685,6.79191,172043
1491,ramkrishnan8994,1,0.00058,11686,6.79249,172043
1492,rbadillo,1,0.00058,11687,6.79307,172043
1493,rbcek,1,0.00058,11688,6.79365,172043
1494,RcrsvSquid,1,0.00058,11689,6.79423,172043
1495,redriverhong,1,0.00058,11690,6.79481,172043
1496,renhuanyu,1,0.00058,11691,6.79539,172043
1497,research-sudo,1,0.00058,11692,6.79598,172043
1498,ridewindx,1,0.00058,11693,6.79656,172043
1499,Riete,1,0.00058,11694,6.79714,172043
1500,RiioDeezy,1,0.00058,11695,6.79772,172043
1501,riktimmondal,1,0.00058,11696,6.79830,172043
1502,riponbanik,1,0.00058,11697,6.79888,172043
1503,ritikofficial,1,0.00058,11698,6.79946,172043
1504,RobHofmann,1,0.00058,11699,6.80004,172043
1505,RobReus,1,0.00058,11700,6.80063,172043
1506,rohansadale,1,0.00058,11701,6.80121,172043
1507,Rohith09,1,0.00058,11702,6.80179,172043
1508,romain325,1,0.00058,11703,6.80237,172043
1509,romainrossi,1,0.00058,11704,6.80295,172043
1510,roosmaa,1,0.00058,11705,6.80353,172043
1511,RottenLeaf24,1,0.00058,11706,6.80411,172043
1512,rpsingh21,1,0.00058,11707,6.80469,172043
1513,rraj-gautam,1,0.00058,11708,6.80528,172043
1514,ruwan1235,1,0.00058,11709,6.80586,172043
1515,rv404674,1,0.00058,11710,6.80644,172043
1516,rwxrob,1,0.00058,11711,6.80702,172043
1517,ryanfaircloth,1,0.00058,11712,6.80760,172043
1518,ryanrussell,1,0.00058,11713,6.80818,172043
1519,sachinshakya507,1,0.00058,11714,6.80876,172043
1520,SahilSayani,1,0.00058,11715,6.80934,172043
1521,Saiyam7404,1,0.00058,11716,6.80993,172043
1522,sakkshm,1,0.00058,11717,6.81051,172043
1523,sanbro123,1,0.00058,11718,6.81109,172043
1524,SandeepGamot,1,0.00058,11719,6.81167,172043
1525,sandeepkumarpani888,1,0.00058,11720,6.81225,172043
1526,sandhya77,1,0.00058,11721,6.81283,172043
1527,sandhya7797,1,0.00058,11722,6.81341,172043
1528,sanshay,1,0.00058,11723,6.81399,172043
1529,santosh09142,1,0.00058,11724,6.81458,172043
1530,SanyuktaSaha,1,0.00058,11725,6.81516,172043
1531,saqibzaib,1,0.00058,11726,6.81574,172043
1532,Sarthakagarwal22,1,0.00058,11727,6.81632,172043
1533,saulmmendoza,1,0.00058,11728,6.81690,172043
1534,saxcorp,1,0.00058,11729,6.81748,172043
1535,sccalabr,1,0.00058,11730,6.81806,172043
1536,seanrclayton,1,0.00058,11731,6.81864,172043
1537,sepich,1,0.00058,11732,6.81923,172043
1538,shahbazahmed1269,1,0.00058,11733,6.81981,172043
1539,Sharma-Rajat,1,0.00058,11734,6.82039,172043
1540,shashishekhar11,1,0.00058,11735,6.82097,172043
1541,shaziya47,1,0.00058,11736,6.82155,172043
1542,shgattu,1,0.00058,11737,6.82213,172043
1543,SHIKHER09,1,0.00058,11738,6.82271,172043
1544,shirkevich,1,0.00058,11739,6.82329,172043
1545,shivam077,1,0.00058,11740,6.82388,172043
1546,Shivang0,1,0.00058,11741,6.82446,172043
1547,ShivaniThevar,1,0.00058,11742,6.82504,172043
1548,shmick,1,0.00058,11743,6.82562,172043
1549,ShraddhaGeek,1,0.00058,11744,6.82620,172043
1550,shturman,1,0.00058,11745,6.82678,172043
1551,siddhi523,1,0.00058,11746,6.82736,172043
1552,S-ign,1,0.00058,11747,6.82794,172043
1553,simonliska,1,0.00058,11748,6.82853,172043
1554,simonwh,1,0.00058,11749,6.82911,172043
1555,sinfull1,1,0.00058,11750,6.82969,172043
1556,SinithH,1,0.00058,11751,6.83027,172043
1557,sk-credify,1,0.00058,11752,6.83085,172043
1558,skvishy27,1,0.00058,11753,6.83143,172043
1559,slothtae,1,0.00058,11754,6.83201,172043
1560,Solomon98,1,0.00058,11755,6.83259,172043
1561,Somsubhra1,1,0.00058,11756,6.83318,172043
1562,sonumeewa,1,0.00058,11757,6.83376,172043
1563,soumya-dash3,1,0.00058,11758,6.83434,172043
1564,soumya-ranjan7,1,0.00058,11759,6.83492,172043
1565,souptik1256,1,0.00058,11760,6.83550,172043
1566,spacether,1,0.00058,11761,6.83608,172043
1567,spectordotan,1,0.00058,11762,6.83666,172043
1568,spheromak,1,0.00058,11763,6.83724,172043
1569,Spiegie,1,0.00058,11764,6.83783,172043
1570,spmason,1,0.00058,11765,6.83841,172043
1571,sprat,1,0.00058,11766,6.83899,172043
1572,srkaviani,1,0.00058,11767,6.83957,172043
1573,ssaumya97,1,0.00058,11768,6.84015,172043
1574,ssharma2089,1,0.00058,11769,6.84073,172043
1575,stas2k,1,0.00058,11770,6.84131,172043
1576,stelford,1,0.00058,11771,6.84189,172043
1577,stncrn,1,0.00058,11772,6.84248,172043
1578,stop-coding,1,0.00058,11773,6.84306,172043
1579,storymode7,1,0.00058,11774,6.84364,172043
1580,stygmate,1,0.00058,11775,6.84422,172043
1581,sukurcf,1,0.00058,11776,6.84480,172043
1582,sunileman,1,0.00058,11777,6.84538,172043
1583,sunilemanjee,1,0.00058,11778,6.84596,172043
1584,surana-mudit,1,0.00058,11779,6.84654,172043
1585,swapagarwal,1,0.00058,11780,6.84713,172043
1586,Swastyy,1,0.00058,11781,6.84771,172043
1587,szshary,1,0.00058,11782,6.84829,172043
1588,tacoelho,1,0.00058,11783,6.84887,172043
1589,taliesins,1,0.00058,11784,6.84945,172043
1590,tanishajalota,1,0.00058,11785,6.85003,172043
1591,tburschka,1,0.00058,11786,6.85061,172043
1592,tcrst,1,0.00058,11787,6.85119,172043
1593,teamosceola,1,0.00058,11788,6.85178,172043
1594,tedivm,1,0.00058,11789,6.85236,172043
1595,tengdagg,1,0.00058,11790,6.85294,172043
1596,testwill,1,0.00058,11791,6.85352,172043
1597,tharudaya,1,0.00058,11792,6.85410,172043
1598,theharshitgarg,1,0.00058,11793,6.85468,172043
1599,Thejasri,1,0.00058,11794,6.85526,172043
1600,ThomasBuchinger,1,0.00058,11795,6.85584,172043
1601,thoot-235,1,0.00058,11796,6.85643,172043
1602,tkivisik,1,0.00058,11797,6.85701,172043
1603,tklae,1,0.00058,11798,6.85759,172043
1604,tmsdce,1,0.00058,11799,6.85817,172043
1605,ToroNZ,1,0.00058,11800,6.85875,172043
1606,tottoto,1,0.00058,11801,6.85933,172043
1607,TrAnn3l,1,0.00058,11802,6.85991,172043
1608,trinity0091,1,0.00058,11803,6.86049,172043
1609,TrueGoric,1,0.00058,11804,6.86108,172043
1610,Trungdo253,1,0.00058,11805,6.86166,172043
1611,TwistedHardware,1,0.00058,11806,6.86224,172043
1612,typokign,1,0.00058,11807,6.86282,172043
1613,TyR3x123,1,0.00058,11808,6.86340,172043
1614,unixlab,1,0.00058,11809,6.86398,172043
1615,upward4,1,0.00058,11810,6.86456,172043
1616,useltmann,1,0.00058,11811,6.86514,172043
1617,uu1t,1,0.00058,11812,6.86573,172043
1618,vagdevik,1,0.00058,11813,6.86631,172043
1619,Vaishnavi-cyber-blip,1,0.00058,11814,6.86689,172043
1620,Val,1,0.00058,11815,6.86747,172043
1621,vantonio,1,0.00058,11816,6.86805,172043
1622,varunjoshi29,1,0.00058,11817,6.86863,172043
1623,vchrisb,1,0.00058,11818,6.86921,172043
1624,venkatvani,1,0.00058,11819,6.86979,172043
1625,vholer,1,0.00058,11820,6.87038,172043
1626,vibornoff,1,0.00058,11821,6.87096,172043
1627,vickxy,1,0.00058,11822,6.87154,172043
1628,vijayscsa,1,0.00058,11823,6.87212,172043
1629,vinayak017,1,0.00058,11824,6.87270,172043
1630,vincedihub,1,0.00058,11825,6.87328,172043
1631,vinerich,1,0.00058,11826,6.87386,172043
1632,vinitparak,1,0.00058,11827,6.87444,172043
1633,vistasunil,1,0.00058,11828,6.87503,172043
1634,vivaol,1,0.00058,11829,6.87561,172043
1635,viveksonar,1,0.00058,11830,6.87619,172043
1636,viveksoundrapandi,1,0.00058,11831,6.87677,172043
1637,vivex,1,0.00058,11832,6.87735,172043
1638,vkassingh,1,0.00058,11833,6.87793,172043
1639,vlads123,1,0.00058,11834,6.87851,172043
1640,vmasule,1,0.00058,11835,6.87909,172043
1641,voarsh2,1,0.00058,11836,6.87968,172043
1642,vsabavat,1,0.00058,11837,6.88026,172043
1643,vyas-n,1,0.00058,11838,6.88084,172043
1644,walnuss0815,1,0.00058,11839,6.88142,172043
1645,wanderer163,1,0.00058,11840,6.88200,172043
1646,webdog,1,0.00058,11841,6.88258,172043
1647,weizenberg,1,0.00058,11842,6.88316,172043
1648,wer12345,1,0.00058,11843,6.88374,172043
1649,whatupcoder,1,0.00058,11844,6.88433,172043
1650,wildapt01,1,0.00058,11845,6.88491,172043
1651,wilfriedroset,1,0.00058,11846,6.88549,172043
1652,Winter-Guerra,1,0.00058,11847,6.88607,172043
1653,WMP,1,0.00058,11848,6.88665,172043
1654,WojoInc,1,0.00058,11849,6.88723,172043
1655,xiafan68,1,0.00058,11850,6.88781,172043
1656,xiaobaolxy,1,0.00058,11851,6.88839,172043
1657,xjbdjay,1,0.00058,11852,6.88898,172043
1658,xyhhx,1,0.00058,11853,6.88956,172043
1659,yajo,1,0.00058,11854,6.89014,172043
1660,yash97,1,0.00058,11855,6.89072,172043
1661,yash-goien,1,0.00058,11856,6.89130,172043
1662,Yashs911,1,0.00058,11857,6.89188,172043
1663,ybnelson,1,0.00058,11858,6.89246,172043
1664,Yelijah,1,0.00058,11859,6.89304,172043
1665,yhrenlee,1,0.00058,11860,6.89363,172043
1666,Yseona,1,0.00058,11861,6.89421,172043
1667,zaidishahbaz,1,0.00058,11862,6.89479,172043
1668,zarez,1,0.00058,11863,6.89537,172043
1669,zengxu87,1,0.00058,11864,6.89595,172043
1670,zhangcly,1,0.00058,11865,6.89653,172043
1671,zhegemingzimeibanquan,1,0.00058,11866,6.89711,172043
1672,zoetrope,1,0.00058,11867,6.89769,172043
1673,zrav,1,0.00058,11868,6.89828,172043
