rank_number,actor,contributions,percent,cumulative_sum,cumulative_percent,all_contributions
1,odockal,3671,4.40543,3671,4.40543,83329
2,cbr7,2073,2.48773,5744,6.89316,83329
3,gastoner,933,1.11966,6677,8.01282,83329
4,SoniaSandler,678,0.81364,7355,8.82646,83329
5,ScrewTSW,570,0.68404,7925,9.51049,83329
6,ekidneyrh,426,0.51123,8351,10.02172,83329
7,amisskii,416,0.49923,8767,10.52095,83329
8,shipsing,415,0.49803,9182,11.01897,83329
9,deekay2310,266,0.31922,9448,11.33819,83329
10,Firewall,194,0.23281,9642,11.57100,83329
11,MariaLeonova,175,0.21001,9817,11.78101,83329
12,xbabalov,152,0.18241,9969,11.96342,83329
13,nichjones1,136,0.16321,10105,12.12663,83329
14,rostalan,130,0.15601,10235,12.28264,83329
15,danivilla9,104,0.12481,10339,12.40745,83329
16,dylanmtaylor,69,0.08280,10408,12.49025,83329
17,trmendes,67,0.08040,10475,12.57065,83329
18,tony-sol,60,0.07200,10535,12.64266,83329
19,tppalani,44,0.05280,10579,12.69546,83329
20,n1hility,34,0.04080,10613,12.73626,83329
21,cedricclyburn,27,0.03240,10640,12.76866,83329
22,gbengaoti,26,0.03120,10666,12.79987,83329
23,djnotes,25,0.03000,10691,12.82987,83329
24,GLEF1X,24,0.02880,10715,12.85867,83329
25,rujutashinde,24,0.02880,10739,12.88747,83329
26,myfear,21,0.02520,10760,12.91267,83329
27,arixmkii,20,0.02400,10780,12.93667,83329
28,rahulbtchrya,18,0.02160,10798,12.95827,83329
29,ggiguash,16,0.01920,10814,12.97747,83329
30,rdbisme,16,0.01920,10830,12.99668,83329
31,Tony-Sol,16,0.01920,10846,13.01588,83329
32,tuckerrc,16,0.01920,10862,13.03508,83329
33,bwgjoseph,15,0.01800,10877,13.05308,83329
34,jannikbertram,15,0.01800,10892,13.07108,83329
35,RobotSail,15,0.01800,10907,13.08908,83329
36,Blaimi,14,0.01680,10921,13.10588,83329
37,jingyuwa,14,0.01680,10935,13.12268,83329
38,Malix-off,14,0.01680,10949,13.13948,83329
39,vietk,14,0.01680,10963,13.15628,83329
40,AlexonOliveiraRH,13,0.01560,10976,13.17188,83329
41,ankanroy-code,13,0.01560,10989,13.18749,83329
42,Luxvao,13,0.01560,11002,13.20309,83329
43,Durus-R,12,0.01440,11014,13.21749,83329
44,elervik,12,0.01440,11026,13.23189,83329
45,fschwa,12,0.01440,11038,13.24629,83329
46,redwerkz,12,0.01440,11050,13.26069,83329
47,tnk4on,12,0.01440,11062,13.27509,83329
48,computator,11,0.01320,11073,13.28829,83329
49,heidenthal-gtisoft,11,0.01320,11084,13.30149,83329
50,itzikb,11,0.01320,11095,13.31469,83329
51,ConorC117,10,0.01200,11105,13.32669,83329
52,jmartisk,10,0.01200,11115,13.33869,83329
53,lucaisacoder,10,0.01200,11125,13.35069,83329
54,MarkCheshire,10,0.01200,11135,13.36269,83329
55,mrguitar,10,0.01200,11145,13.37470,83329
56,sfrunza13,10,0.01200,11155,13.38670,83329
57,sounix000,10,0.01200,11165,13.39870,83329
58,alexojegu,9,0.01080,11174,13.40950,83329
59,FancyBanana,9,0.01080,11183,13.42030,83329
60,FilBot3,9,0.01080,11192,13.43110,83329
61,hiahab,9,0.01080,11201,13.44190,83329
62,Indekkusu545,9,0.01080,11210,13.45270,83329
63,shelar1423,9,0.01080,11219,13.46350,83329
64,ttys3,9,0.01080,11228,13.47430,83329
65,YuHanHaHa,9,0.01080,11237,13.48510,83329
66,edvardsanta,8,0.00960,11245,13.49470,83329
67,eric-peterson-usps,8,0.00960,11253,13.50430,83329
68,fipro78,8,0.00960,11261,13.51390,83329
69,fmuntean,8,0.00960,11269,13.52350,83329
70,hansmbakker,8,0.00960,11277,13.53310,83329
71,isaacsgi,8,0.00960,11285,13.54270,83329
72,jedthe3rd,8,0.00960,11293,13.55230,83329
73,Julian,8,0.00960,11301,13.56191,83329
74,mattreid,8,0.00960,11309,13.57151,83329
75,shblue21,8,0.00960,11317,13.58111,83329
76,singodiyashubham87,8,0.00960,11325,13.59071,83329
77,veniceofcode,8,0.00960,11333,13.60031,83329
78,albertowd,7,0.00840,11340,13.60871,83329
79,DaRealCapz,7,0.00840,11347,13.61711,83329
80,dcatwoohoo,7,0.00840,11354,13.62551,83329
81,fc7,7,0.00840,11361,13.63391,83329
82,mohanigs,7,0.00840,11368,13.64231,83329
83,PatentLobster,7,0.00840,11375,13.65071,83329
84,rrbanda,7,0.00840,11382,13.65911,83329
85,steveoh,7,0.00840,11389,13.66751,83329
86,symplrdudley,7,0.00840,11396,13.67591,83329
87,acud1,6,0.00720,11402,13.68311,83329
88,aditipatelpro,6,0.00720,11408,13.69031,83329
89,bathivinod,6,0.00720,11414,13.69751,83329
90,BinaryWizard904,6,0.00720,11420,13.70471,83329
91,birla,6,0.00720,11426,13.71191,83329
92,cu8code,6,0.00720,11432,13.71911,83329
93,damaestro,6,0.00720,11438,13.72631,83329
94,Drugoy,6,0.00720,11444,13.73351,83329
95,ecrookshanks-rh,6,0.00720,11450,13.74071,83329
96,faandg,6,0.00720,11456,13.74791,83329
97,failboat79,6,0.00720,11462,13.75512,83329
98,finanalyst,6,0.00720,11468,13.76232,83329
99,francoism90,6,0.00720,11474,13.76952,83329
100,harryssuperman,6,0.00720,11480,13.77672,83329
101,Hygens,6,0.00720,11486,13.78392,83329
102,JayDoubleu,6,0.00720,11492,13.79112,83329
103,jgresham,6,0.00720,11498,13.79832,83329
104,krachynski,6,0.00720,11504,13.80552,83329
105,lethargosapatheia,6,0.00720,11510,13.81272,83329
106,lmilbaum,6,0.00720,11516,13.81992,83329
107,n2029-ndensan,6,0.00720,11522,13.82712,83329
108,nr23730,6,0.00720,11528,13.83432,83329
109,ReadingShades,6,0.00720,11534,13.84152,83329
110,SeanFelipe,6,0.00720,11540,13.84872,83329
111,sstosh,6,0.00720,11546,13.85592,83329
112,totkeks,6,0.00720,11552,13.86312,83329
113,trymeouteh,6,0.00720,11558,13.87032,83329
114,vandrep,6,0.00720,11564,13.87752,83329
115,Ac0lyte,5,0.00600,11569,13.88352,83329
116,asamalik,5,0.00600,11574,13.88952,83329
117,bcalatoz,5,0.00600,11579,13.89552,83329
118,benemon,5,0.00600,11584,13.90152,83329
119,cegeka-jd,5,0.00600,11589,13.90752,83329
120,chevdor,5,0.00600,11594,13.91352,83329
121,chkpnt,5,0.00600,11599,13.91952,83329
122,datho7561,5,0.00600,11604,13.92552,83329
123,fatelei,5,0.00600,11609,13.93152,83329
124,j2stream,5,0.00600,11614,13.93752,83329
125,J3RN,5,0.00600,11619,13.94353,83329
126,Joeyyubo,5,0.00600,11624,13.94953,83329
127,kgalli,5,0.00600,11629,13.95553,83329
128,markfaine,5,0.00600,11634,13.96153,83329
129,MichaelClifford,5,0.00600,11639,13.96753,83329
130,Mohit-Gaur,5,0.00600,11644,13.97353,83329
131,mydeveloperplanet,5,0.00600,11649,13.97953,83329
132,nzineer,5,0.00600,11654,13.98553,83329
133,PunkFleet,5,0.00600,11659,13.99153,83329
134,rahul0x00,5,0.00600,11664,13.99753,83329
135,soyers,5,0.00600,11669,14.00353,83329
136,sshambar,5,0.00600,11674,14.00953,83329
137,TheConen,5,0.00600,11679,14.01553,83329
138,timheuer,5,0.00600,11684,14.02153,83329
139,tmancill,5,0.00600,11689,14.02753,83329
140,adietish,4,0.00480,11693,14.03233,83329
141,akrueger,4,0.00480,11697,14.03713,83329
142,annng,4,0.00480,11701,14.04193,83329
143,AntonAntonich,4,0.00480,11705,14.04673,83329
144,bmos300,4,0.00480,11709,14.05153,83329
145,BurntVoxel,4,0.00480,11713,14.05633,83329
146,ctCxc,4,0.00480,11717,14.06113,83329
147,dougbreaux,4,0.00480,11721,14.06593,83329
148,farahats9,4,0.00480,11725,14.07073,83329
149,foxydevloper,4,0.00480,11729,14.07553,83329
150,FrCornaire,4,0.00480,11733,14.08033,83329
151,gaetschwartz,4,0.00480,11737,14.08513,83329
152,gbgbapsps2,4,0.00480,11741,14.08993,83329
153,gnmerritt,4,0.00480,11745,14.09473,83329
154,gudge25,4,0.00480,11749,14.09953,83329
155,ikovalyov,4,0.00480,11753,14.10433,83329
156,imphil,4,0.00480,11757,14.10913,83329
157,ivardu,4,0.00480,11761,14.11393,83329
158,JauntyJames,4,0.00480,11765,14.11873,83329
159,jchenibm,4,0.00480,11769,14.12353,83329
160,jrmanisme,4,0.00480,11773,14.12833,83329
161,kaizencon,4,0.00480,11777,14.13313,83329
162,kartas39,4,0.00480,11781,14.13794,83329
163,koisurunippon,4,0.00480,11785,14.14274,83329
164,Maple200-bit,4,0.00480,11789,14.14754,83329
165,mkyrilov,4,0.00480,11793,14.15234,83329
166,napoleontan,4,0.00480,11797,14.15714,83329
167,nitinkale,4,0.00480,11801,14.16194,83329
168,oappicgi,4,0.00480,11805,14.16674,83329
169,peterwwillis,4,0.00480,11809,14.17154,83329
170,PStoner3,4,0.00480,11813,14.17634,83329
171,radboudp,4,0.00480,11817,14.18114,83329
172,rafaeltuelho,4,0.00480,11821,14.18594,83329
173,redhatrises,4,0.00480,11825,14.19074,83329
174,rohit-rambade,4,0.00480,11829,14.19554,83329
175,scscgit,4,0.00480,11833,14.20034,83329
176,shikari7,4,0.00480,11837,14.20514,83329
177,sockejr,4,0.00480,11841,14.20994,83329
178,Spitfire1900,4,0.00480,11845,14.21474,83329
179,taazadrishtikon,4,0.00480,11849,14.21954,83329
180,telometto,4,0.00480,11853,14.22434,83329
181,Thadir,4,0.00480,11857,14.22914,83329
182,TomasHubelbauer,4,0.00480,11861,14.23394,83329
183,tombenninger,4,0.00480,11865,14.23874,83329
184,tonycody,4,0.00480,11869,14.24354,83329
185,uniquejava,4,0.00480,11873,14.24834,83329
186,Zomono,4,0.00480,11877,14.25314,83329
187,ZPOMI,4,0.00480,11881,14.25794,83329
188,aednichols,3,0.00360,11884,14.26154,83329
189,ajram23,3,0.00360,11887,14.26514,83329
190,alexanderniebuhr,3,0.00360,11890,14.26874,83329
191,AlexandrStarov,3,0.00360,11893,14.27234,83329
192,andreaippo,3,0.00360,11896,14.27594,83329
193,Andres6936,3,0.00360,11899,14.27954,83329
194,anunayamar,3,0.00360,11902,14.28314,83329
195,AsciiWolf,3,0.00360,11905,14.28674,83329
196,ashley-cui,3,0.00360,11908,14.29034,83329
197,ateska,3,0.00360,11911,14.29394,83329
198,baod-rate,3,0.00360,11914,14.29754,83329
199,bhundven,3,0.00360,11917,14.30114,83329
200,bodzebod,3,0.00360,11920,14.30474,83329
201,brainbytes42,3,0.00360,11923,14.30834,83329
202,bricss,3,0.00360,11926,14.31194,83329
203,burner1024,3,0.00360,11929,14.31554,83329
204,cgx-system,3,0.00360,11932,14.31914,83329
205,ckyrouac,3,0.00360,11935,14.32274,83329
206,cryptomilk,3,0.00360,11938,14.32634,83329
207,curd0,3,0.00360,11941,14.32995,83329
208,D3vil0p3r,3,0.00360,11944,14.33355,83329
209,damlys99,3,0.00360,11947,14.33715,83329
210,dansiviter,3,0.00360,11950,14.34075,83329
211,davpea,3,0.00360,11953,14.34435,83329
212,eddumelendez,3,0.00360,11956,14.34795,83329
213,elico,3,0.00360,11959,14.35155,83329
214,ermasavior,3,0.00360,11962,14.35515,83329
215,evanfpearson,3,0.00360,11965,14.35875,83329
216,Ferenc-,3,0.00360,11968,14.36235,83329
217,fuzzykiller,3,0.00360,11971,14.36595,83329
218,GamerPanda99,3,0.00360,11974,14.36955,83329
219,gerroon,3,0.00360,11977,14.37315,83329
220,ghubstan,3,0.00360,11980,14.37675,83329
221,gicat,3,0.00360,11983,14.38035,83329
222,goremykin,3,0.00360,11986,14.38395,83329
223,gotmax23,3,0.00360,11989,14.38755,83329
224,gt-dltk,3,0.00360,11992,14.39115,83329
225,harleydk,3,0.00360,11995,14.39475,83329
226,hyoretsu,3,0.00360,11998,14.39835,83329
227,iGwkang,3,0.00360,12001,14.40195,83329
228,inoyakaigor,3,0.00360,12004,14.40555,83329
229,ionutss,3,0.00360,12007,14.40915,83329
230,JDUNNIN,3,0.00360,12010,14.41275,83329
231,jgcotta,3,0.00360,12013,14.41635,83329
232,jlogan-github,3,0.00360,12016,14.41995,83329
233,jlosito,3,0.00360,12019,14.42355,83329
234,josealbertocoronado,3,0.00360,12022,14.42715,83329
235,josephgruber,3,0.00360,12025,14.43075,83329
236,kachick,3,0.00360,12028,14.43435,83329
237,kontsaki,3,0.00360,12031,14.43795,83329
238,lamaelnaggarcra,3,0.00360,12034,14.44155,83329
239,martin-juul,3,0.00360,12037,14.44515,83329
240,mejobloggs-cw,3,0.00360,12040,14.44875,83329
241,mixtah,3,0.00360,12043,14.45235,83329
242,mmm8955405,3,0.00360,12046,14.45595,83329
243,msilmser,3,0.00360,12049,14.45955,83329
244,neoziro,3,0.00360,12052,14.46315,83329
245,Neurrone,3,0.00360,12055,14.46675,83329
246,NezSez,3,0.00360,12058,14.47035,83329
247,nikolaqm,3,0.00360,12061,14.47395,83329
248,nimeshikkaAma,3,0.00360,12064,14.47755,83329
249,orpiske,3,0.00360,12067,14.48115,83329
250,pcartwright81,3,0.00360,12070,14.48475,83329
251,pigiax,3,0.00360,12073,14.48835,83329
252,p-kager,3,0.00360,12076,14.49195,83329
253,polzka90,3,0.00360,12079,14.49555,83329
254,RabbitSharp,3,0.00360,12082,14.49915,83329
255,razzeee,3,0.00360,12085,14.50275,83329
256,rbargerhuff,3,0.00360,12088,14.50635,83329
257,rommon,3,0.00360,12091,14.50995,83329
258,sallyahaj,3,0.00360,12094,14.51355,83329
259,SanchitMahajan236,3,0.00360,12097,14.51715,83329
260,SashaPetrovska,3,0.00360,12100,14.52076,83329
261,siddhartharoy,3,0.00360,12103,14.52436,83329
262,simonmacor,3,0.00360,12106,14.52796,83329
263,simorex80,3,0.00360,12109,14.53156,83329
264,stitchik,3,0.00360,12112,14.53516,83329
265,svdimchenko,3,0.00360,12115,14.53876,83329
266,svoop,3,0.00360,12118,14.54236,83329
267,tanwald,3,0.00360,12121,14.54596,83329
268,taspeotis,3,0.00360,12124,14.54956,83329
269,tazihad,3,0.00360,12127,14.55316,83329
270,ymurawski,3,0.00360,12130,14.55676,83329
271,yogeshpmandre,3,0.00360,12133,14.56036,83329
272,z-aki,3,0.00360,12136,14.56396,83329
273,alxlenc,2,0.00240,12138,14.56636,83329
274,AndreaLombardo,2,0.00240,12140,14.56876,83329
275,ariellourenco,2,0.00240,12142,14.57116,83329
276,ashimov,2,0.00240,12144,14.57356,83329
277,avolts,2,0.00240,12146,14.57596,83329
278,aysabzevar,2,0.00240,12148,14.57836,83329
279,bit4man,2,0.00240,12150,14.58076,83329
280,borazem,2,0.00240,12152,14.58316,83329
281,botbench,2,0.00240,12154,14.58556,83329
282,bovem,2,0.00240,12156,14.58796,83329
283,bphd,2,0.00240,12158,14.59036,83329
284,brunomcuesta,2,0.00240,12160,14.59276,83329
285,caaromerogi,2,0.00240,12162,14.59516,83329
286,codermonkey55,2,0.00240,12164,14.59756,83329
287,crahan,2,0.00240,12166,14.59996,83329
288,dark-developer15,2,0.00240,12168,14.60236,83329
289,DarkModz-Official,2,0.00240,12170,14.60476,83329
290,David47295,2,0.00240,12172,14.60716,83329
291,dc-me,2,0.00240,12174,14.60956,83329
292,deversmann,2,0.00240,12176,14.61196,83329
293,DimamoN,2,0.00240,12178,14.61436,83329
294,Dogacel,2,0.00240,12180,14.61676,83329
295,DonSchenck,2,0.00240,12182,14.61916,83329
296,dpoerschke,2,0.00240,12184,14.62156,83329
297,duyetpt,2,0.00240,12186,14.62396,83329
298,edoger,2,0.00240,12188,14.62636,83329
299,EdwinKM,2,0.00240,12190,14.62876,83329
300,elhananjair,2,0.00240,12192,14.63116,83329
301,EnderWolf50,2,0.00240,12194,14.63356,83329
302,ericwill,2,0.00240,12196,14.63596,83329
303,evenreven,2,0.00240,12198,14.63836,83329
304,FilipJirsak,2,0.00240,12200,14.64076,83329
305,fnoorden,2,0.00240,12202,14.64316,83329
306,fokusuma,2,0.00240,12204,14.64556,83329
307,fulldecent,2,0.00240,12206,14.64796,83329
308,gbakeman,2,0.00240,12208,14.65036,83329
309,ghahvebaz,2,0.00240,12210,14.65276,83329
310,gian1200,2,0.00240,12212,14.65516,83329
311,Gr3at,2,0.00240,12214,14.65756,83329
312,Gregory-Pereira,2,0.00240,12216,14.65996,83329
313,GuusDeGraeve,2,0.00240,12218,14.66236,83329
314,harsh-solanki21,2,0.00240,12220,14.66476,83329
315,hofq,2,0.00240,12222,14.66716,83329
316,houshym,2,0.00240,12224,14.66956,83329
317,Huskydog9988,2,0.00240,12226,14.67196,83329
318,ibre5041,2,0.00240,12228,14.67436,83329
319,icnocop,2,0.00240,12230,14.67676,83329
320,idjohnson,2,0.00240,12232,14.67916,83329
321,ItsJamie9494,2,0.00240,12234,14.68156,83329
322,James-Mat,2,0.00240,12236,14.68396,83329
323,jamjon3,2,0.00240,12238,14.68636,83329
324,janderssonse,2,0.00240,12240,14.68876,83329
325,Jap8nted,2,0.00240,12242,14.69116,83329
326,jbarwick,2,0.00240,12244,14.69356,83329
327,jdelker,2,0.00240,12246,14.69596,83329
328,Jedi-5,2,0.00240,12248,14.69836,83329
329,joaoopereira,2,0.00240,12250,14.70076,83329
330,JoelDSmith,2,0.00240,12252,14.70316,83329
331,johwes,2,0.00240,12254,14.70556,83329
332,JPBarringer,2,0.00240,12256,14.70796,83329
333,jski,2,0.00240,12258,14.71036,83329
334,karstengresch,2,0.00240,12260,14.71277,83329
335,kenbarnettpt,2,0.00240,12262,14.71517,83329
336,Keyvan-rh,2,0.00240,12264,14.71757,83329
337,kush-gupt,2,0.00240,12266,14.71997,83329
338,leepa,2,0.00240,12268,14.72237,83329
339,lepus,2,0.00240,12270,14.72477,83329
340,lgonzalezsa,2,0.00240,12272,14.72717,83329
341,Liaomessi,2,0.00240,12274,14.72957,83329
342,LiZhang19817,2,0.00240,12276,14.73197,83329
343,lucasleon2107,2,0.00240,12278,14.73437,83329
344,MajorBreakfast,2,0.00240,12280,14.73677,83329
345,maxsxu,2,0.00240,12282,14.73917,83329
346,MING-LI-JIANG,2,0.00240,12284,14.74157,83329
347,Mitch9378,2,0.00240,12286,14.74397,83329
348,mlanner,2,0.00240,12288,14.74637,83329
349,muayyad-alsadi,2,0.00240,12290,14.74877,83329
350,mvromer,2,0.00240,12292,14.75117,83329
351,neurogenesis,2,0.00240,12294,14.75357,83329
352,NicoWde,2,0.00240,12296,14.75597,83329
353,nithinbandaru1,2,0.00240,12298,14.75837,83329
354,nt-baker,2,0.00240,12300,14.76077,83329
355,NucleaPeon,2,0.00240,12302,14.76317,83329
356,orblazer,2,0.00240,12304,14.76557,83329
357,ParaplegicRacehorse,2,0.00240,12306,14.76797,83329
358,patricsgamma,2,0.00240,12308,14.77037,83329
359,phillies,2,0.00240,12310,14.77277,83329
360,p-vascool,2,0.00240,12312,14.77517,83329
361,qubidt,2,0.00240,12314,14.77757,83329
362,renatoppuccini,2,0.00240,12316,14.77997,83329
363,rh-jelabarre,2,0.00240,12318,14.78237,83329
364,RiverVenton,2,0.00240,12320,14.78477,83329
365,robertcrockett,2,0.00240,12322,14.78717,83329
366,RoseyWasTaken,2,0.00240,12324,14.78957,83329
367,rv2931,2,0.00240,12326,14.79197,83329
368,ryanking8215,2,0.00240,12328,14.79437,83329
369,silopolis,2,0.00240,12330,14.79677,83329
370,sofpodev,2,0.00240,12332,14.79917,83329
371,SohanTirpude,2,0.00240,12334,14.80157,83329
372,spamkutu,2,0.00240,12336,14.80397,83329
373,sprior,2,0.00240,12338,14.80637,83329
374,supachris28,2,0.00240,12340,14.80877,83329
375,swelborn,2,0.00240,12342,14.81117,83329
376,techert,2,0.00240,12344,14.81357,83329
377,ths83,2,0.00240,12346,14.81597,83329
378,timia2109,2,0.00240,12348,14.81837,83329
379,torbica,2,0.00240,12350,14.82077,83329
380,vl-twinsec,2,0.00240,12352,14.82317,83329
381,wolf99,2,0.00240,12354,14.82557,83329
382,xkevas24,2,0.00240,12356,14.82797,83329
383,yxing-xyz,2,0.00240,12358,14.83037,83329
384,zakaria-chahboun,2,0.00240,12360,14.83277,83329
385,ziad-saade,2,0.00240,12362,14.83517,83329
386,0x656b694d,1,0.00120,12363,14.83637,83329
387,aaccioly-zepz,1,0.00120,12364,14.83757,83329
388,aaraodeo,1,0.00120,12365,14.83877,83329
389,abdullahcicekli,1,0.00120,12366,14.83997,83329
390,acancell-redhat,1,0.00120,12367,14.84117,83329
391,Admiralfeb,1,0.00120,12368,14.84237,83329
392,AdrainXie,1,0.00120,12369,14.84357,83329
393,agibson2,1,0.00120,12370,14.84477,83329
394,agiertli,1,0.00120,12371,14.84597,83329
395,agreedSkiing,1,0.00120,12372,14.84717,83329
396,agrisvv,1,0.00120,12373,14.84837,83329
397,ahmetwaly,1,0.00120,12374,14.84957,83329
398,alcon678,1,0.00120,12375,14.85077,83329
399,alexanderadam,1,0.00120,12376,14.85197,83329
400,alv67,1,0.00120,12377,14.85317,83329
401,amaddio,1,0.00120,12378,14.85437,83329
402,Andrysky,1,0.00120,12379,14.85557,83329
403,anil-kk,1,0.00120,12380,14.85677,83329
404,anthonyvdotbe,1,0.00120,12381,14.85797,83329
405,aokugel,1,0.00120,12382,14.85917,83329
406,aolszak,1,0.00120,12383,14.86037,83329
407,AquaBx,1,0.00120,12384,14.86157,83329
408,aramcheck,1,0.00120,12385,14.86277,83329
409,archerallstars,1,0.00120,12386,14.86397,83329
410,arindamchoudhury,1,0.00120,12387,14.86517,83329
411,artificial-intelligence,1,0.00120,12388,14.86637,83329
412,AshvG,1,0.00120,12389,14.86757,83329
413,avlec,1,0.00120,12390,14.86877,83329
414,Axeltherabbit,1,0.00120,12391,14.86997,83329
415,baodrate,1,0.00120,12392,14.87117,83329
416,Basil-Dot-Work,1,0.00120,12393,14.87237,83329
417,bbhtt,1,0.00120,12394,14.87357,83329
418,bbrandt,1,0.00120,12395,14.87477,83329
419,bd5872,1,0.00120,12396,14.87597,83329
420,Bharath-vi,1,0.00120,12397,14.87717,83329
421,biergit,1,0.00120,12398,14.87837,83329
422,bingoct,1,0.00120,12399,14.87957,83329
423,BjoernAkAManf,1,0.00120,12400,14.88077,83329
424,blackhelicoptersdotnet,1,0.00120,12401,14.88197,83329
425,bouncingjack,1,0.00120,12402,14.88317,83329
426,braunsonm,1,0.00120,12403,14.88437,83329
427,briggsyj,1,0.00120,12404,14.88557,83329
428,bshea5,1,0.00120,12405,14.88677,83329
429,byjrack,1,0.00120,12406,14.88797,83329
430,canadaduane,1,0.00120,12407,14.88917,83329
431,Caraveo,1,0.00120,12408,14.89037,83329
432,carljmosca,1,0.00120,12409,14.89157,83329
433,CarlosDomingues,1,0.00120,12410,14.89277,83329
434,carwyn,1,0.00120,12411,14.89397,83329
435,castaglio,1,0.00120,12412,14.89517,83329
436,cazzoo,1,0.00120,12413,14.89637,83329
437,cceelen,1,0.00120,12414,14.89757,83329
438,cetindogu,1,0.00120,12415,14.89877,83329
439,Charuwaka,1,0.00120,12416,14.89997,83329
440,CheColeman,1,0.00120,12417,14.90117,83329
441,cheema-corellian,1,0.00120,12418,14.90237,83329
442,chrisjsimpson,1,0.00120,12419,14.90357,83329
443,ChristiaanNel,1,0.00120,12420,14.90478,83329
444,ciros88,1,0.00120,12421,14.90598,83329
445,Cisnocxie,1,0.00120,12422,14.90718,83329
446,Clockwork-Muse,1,0.00120,12423,14.90838,83329
447,code2exe,1,0.00120,12424,14.90958,83329
448,codesalatdev,1,0.00120,12425,14.91078,83329
449,ColdTeapot273K,1,0.00120,12426,14.91198,83329
450,craslaw,1,0.00120,12427,14.91318,83329
451,craulers,1,0.00120,12428,14.91438,83329
452,cristatus,1,0.00120,12429,14.91558,83329
453,cssmith4,1,0.00120,12430,14.91678,83329
454,ctm8788,1,0.00120,12431,14.91798,83329
455,dacarab,1,0.00120,12432,14.91918,83329
456,damian01w,1,0.00120,12433,14.92038,83329
457,DamianFekete,1,0.00120,12434,14.92158,83329
458,dan-m8t,1,0.00120,12435,14.92278,83329
459,danny-su,1,0.00120,12436,14.92398,83329
460,darkmastermindz,1,0.00120,12437,14.92518,83329
461,davdr,1,0.00120,12438,14.92638,83329
462,DaveWK,1,0.00120,12439,14.92758,83329
463,DavidMGau,1,0.00120,12440,14.92878,83329
464,daviewales,1,0.00120,12441,14.92998,83329
465,default-writer,1,0.00120,12442,14.93118,83329
466,denMaier,1,0.00120,12443,14.93238,83329
467,denyshorman,1,0.00120,12444,14.93358,83329
468,devdilson,1,0.00120,12445,14.93478,83329
469,devurandom,1,0.00120,12446,14.93598,83329
470,DhirajGurav5959,1,0.00120,12447,14.93718,83329
471,dikkeduif,1,0.00120,12448,14.93838,83329
472,dirk68-fu,1,0.00120,12449,14.93958,83329
473,DJXJD,1,0.00120,12450,14.94078,83329
474,DoctorRyner,1,0.00120,12451,14.94198,83329
475,DotSlashChris,1,0.00120,12452,14.94318,83329
476,dpineda,1,0.00120,12453,14.94438,83329
477,dp-sgr,1,0.00120,12454,14.94558,83329
478,dr1nf3rn0,1,0.00120,12455,14.94678,83329
479,dr-hansen,1,0.00120,12456,14.94798,83329
480,Dr-Zany,1,0.00120,12457,14.94918,83329
481,easyDaMan,1,0.00120,12458,14.95038,83329
482,eckseleven,1,0.00120,12459,14.95158,83329
483,EgorPopelyaev,1,0.00120,12460,14.95278,83329
484,enricosoft,1,0.00120,12461,14.95398,83329
485,erharb,1,0.00120,12462,14.95518,83329
486,Erick555,1,0.00120,12463,14.95638,83329
487,EricLarge,1,0.00120,12464,14.95758,83329
488,EricSmekens,1,0.00120,12465,14.95878,83329
489,eternaltyro,1,0.00120,12466,14.95998,83329
490,eveerman,1,0.00120,12467,14.96118,83329
491,fabiobraganet,1,0.00120,12468,14.96238,83329
492,fabrice-aeschbacher,1,0.00120,12469,14.96358,83329
493,fanyufan,1,0.00120,12470,14.96478,83329
494,fatindeed,1,0.00120,12471,14.96598,83329
495,fbricon,1,0.00120,12472,14.96718,83329
496,feibaihengmo,1,0.00120,12473,14.96838,83329
497,flyinke,1,0.00120,12474,14.96958,83329
498,folex,1,0.00120,12475,14.97078,83329
499,fookusuma,1,0.00120,12476,14.97198,83329
500,foriequal0,1,0.00120,12477,14.97318,83329
501,franoisD,1,0.00120,12478,14.97438,83329
502,fride,1,0.00120,12479,14.97558,83329
503,fritzfranzke,1,0.00120,12480,14.97678,83329
504,gadware,1,0.00120,12481,14.97798,83329
505,Gauravtalreja1,1,0.00120,12482,14.97918,83329
506,Gelob,1,0.00120,12483,14.98038,83329
507,ggobbe,1,0.00120,12484,14.98158,83329
508,glassm,1,0.00120,12485,14.98278,83329
509,glongzh,1,0.00120,12486,14.98398,83329
510,grantomation,1,0.00120,12487,14.98518,83329
511,gregberge,1,0.00120,12488,14.98638,83329
512,greg-hydrogen,1,0.00120,12489,14.98758,83329
513,GrimmiMeloni,1,0.00120,12490,14.98878,83329
514,gselig1a,1,0.00120,12491,14.98998,83329
515,guban,1,0.00120,12492,14.99118,83329
516,guillaume154a,1,0.00120,12493,14.99238,83329
517,guraltsev,1,0.00120,12494,14.99358,83329
518,hasys,1,0.00120,12495,14.99478,83329
519,heksview,1,0.00120,12496,14.99598,83329
520,hgkamath,1,0.00120,12497,14.99718,83329
521,HridoyHazard,1,0.00120,12498,14.99838,83329
522,hsnabszhdn,1,0.00120,12499,14.99958,83329
523,htyoung,1,0.00120,12500,15.00078,83329
524,iamaliyousefi,1,0.00120,12501,15.00198,83329
525,ikke-t,1,0.00120,12502,15.00318,83329
526,IllusionaryX,1,0.00120,12503,15.00438,83329
527,iMonZ,1,0.00120,12504,15.00558,83329
528,informeti,1,0.00120,12505,15.00678,83329
529,inklesspen1rus,1,0.00120,12506,15.00798,83329
530,ismailsimsek,1,0.00120,12507,15.00918,83329
531,itinneed2022,1,0.00120,12508,15.01038,83329
532,ivanbarczak,1,0.00120,12509,15.01158,83329
533,ivanlemeshev,1,0.00120,12510,15.01278,83329
534,JackyAnn,1,0.00120,12511,15.01398,83329
535,JamesWiley,1,0.00120,12512,15.01518,83329
536,jamu85,1,0.00120,12513,15.01638,83329
537,Janhouse,1,0.00120,12514,15.01758,83329
538,jaxor24,1,0.00120,12515,15.01878,83329
539,jedahan,1,0.00120,12516,15.01998,83329
540,jeffscottbrown,1,0.00120,12517,15.02118,83329
541,jeffstoner,1,0.00120,12518,15.02238,83329
542,JerryMWeeks,1,0.00120,12519,15.02358,83329
543,jgierer12,1,0.00120,12520,15.02478,83329
544,jkemp814,1,0.00120,12521,15.02598,83329
545,jlous,1,0.00120,12522,15.02718,83329
546,jngross95,1,0.00120,12523,15.02838,83329
547,joaopalma5,1,0.00120,12524,15.02958,83329
548,joezhouchenye,1,0.00120,12525,15.03078,83329
549,johnnykang,1,0.00120,12526,15.03198,83329
550,jonasbjork,1,0.00120,12527,15.03318,83329
551,jpdias,1,0.00120,12528,15.03438,83329
552,jtworm96,1,0.00120,12529,15.03558,83329
553,juergenhemelt,1,0.00120,12530,15.03678,83329
554,JurrianFahner,1,0.00120,12531,15.03798,83329
555,jzfraser,1,0.00120,12532,15.03918,83329
556,k1s,1,0.00120,12533,15.04038,83329
557,Kaffee-Junkie,1,0.00120,12534,15.04158,83329
558,kapkekes,1,0.00120,12535,15.04278,83329
559,kattekrab,1,0.00120,12536,15.04398,83329
560,kavya-karri,1,0.00120,12537,15.04518,83329
561,kenmoini,1,0.00120,12538,15.04638,83329
562,KevinAtSesam,1,0.00120,12539,15.04758,83329
563,kid1412621,1,0.00120,12540,15.04878,83329
564,koba-1,1,0.00120,12541,15.04998,83329
565,krai2104,1,0.00120,12542,15.05118,83329
566,krisdante,1,0.00120,12543,15.05238,83329
567,Kruemelmann,1,0.00120,12544,15.05358,83329
568,ksazhnev,1,0.00120,12545,15.05478,83329
569,kwiatks,1,0.00120,12546,15.05598,83329
570,kwkelly,1,0.00120,12547,15.05718,83329
571,KyeRussell,1,0.00120,12548,15.05838,83329
572,kyy23,1,0.00120,12549,15.05958,83329
573,larrycai,1,0.00120,12550,15.06078,83329
574,lclc,1,0.00120,12551,15.06198,83329
575,leeuwe,1,0.00120,12552,15.06318,83329
576,lemaral,1,0.00120,12553,15.06438,83329
577,LeXofLeviafan,1,0.00120,12554,15.06558,83329
578,lgrossma,1,0.00120,12555,15.06678,83329
579,linkoog,1,0.00120,12556,15.06798,83329
580,lordrip,1,0.00120,12557,15.06918,83329
581,Lotusshaney,1,0.00120,12558,15.07038,83329
582,lpar,1,0.00120,12559,15.07158,83329
583,Luap99,1,0.00120,12560,15.07278,83329
584,luizmalere,1,0.00120,12561,15.07398,83329
585,mancubus77,1,0.00120,12562,15.07518,83329
586,markenzie,1,0.00120,12563,15.07638,83329
587,marukaz,1,0.00120,12564,15.07758,83329
588,MattBelle,1,0.00120,12565,15.07878,83329
589,MaurizioVacca,1,0.00120,12566,15.07998,83329
590,mbledkowski,1,0.00120,12567,15.08118,83329
591,MCalverley,1,0.00120,12568,15.08238,83329
592,mdddj,1,0.00120,12569,15.08358,83329
593,mdkcore0,1,0.00120,12570,15.08478,83329
594,mecrobio,1,0.00120,12571,15.08598,83329
595,mehmandarov,1,0.00120,12572,15.08718,83329
596,memark,1,0.00120,12573,15.08838,83329
597,MichaelGerhart,1,0.00120,12574,15.08958,83329
598,mikepictor,1,0.00120,12575,15.09078,83329
599,mikhey,1,0.00120,12576,15.09198,83329
600,mil1i,1,0.00120,12577,15.09318,83329
601,milutinKY,1,0.00120,12578,15.09438,83329
602,mizmo,1,0.00120,12579,15.09558,83329
603,mjfinney,1,0.00120,12580,15.09679,83329
604,mjknoll,1,0.00120,12581,15.09799,83329
605,mjmenger,1,0.00120,12582,15.09919,83329
606,moderncodes,1,0.00120,12583,15.10039,83329
607,mohan-shash,1,0.00120,12584,15.10159,83329
608,Moortu,1,0.00120,12585,15.10279,83329
609,mortega89,1,0.00120,12586,15.10399,83329
610,mridlen,1,0.00120,12587,15.10519,83329
611,mrthomnas,1,0.00120,12588,15.10639,83329
612,mvannux,1,0.00120,12589,15.10759,83329
613,nabeelmoeen,1,0.00120,12590,15.10879,83329
614,nathan-hook,1,0.00120,12591,15.10999,83329
615,NaTorOG,1,0.00120,12592,15.11119,83329
616,Neil-Smith,1,0.00120,12593,15.11239,83329
617,nettybun,1,0.00120,12594,15.11359,83329
618,neverd1m,1,0.00120,12595,15.11479,83329
619,Nezteb,1,0.00120,12596,15.11599,83329
620,nick-adair,1,0.00120,12597,15.11719,83329
621,NicoleMGF,1,0.00120,12598,15.11839,83329
622,Nitrousoxide,1,0.00120,12599,15.11959,83329
623,notapirate,1,0.00120,12600,15.12079,83329
624,nozzlegear,1,0.00120,12601,15.12199,83329
625,Nyvyan,1,0.00120,12602,15.12319,83329
626,officiallor,1,0.00120,12603,15.12439,83329
627,omertuc,1,0.00120,12604,15.12559,83329
628,orende,1,0.00120,12605,15.12679,83329
629,orgcontrib,1,0.00120,12606,15.12799,83329
630,osslate,1,0.00120,12607,15.12919,83329
631,ottuzzi,1,0.00120,12608,15.13039,83329
632,OZZlE,1,0.00120,12609,15.13159,83329
633,p5,1,0.00120,12610,15.13279,83329
634,pampua84,1,0.00120,12611,15.13399,83329
635,panosru,1,0.00120,12612,15.13519,83329
636,PavelSosin-320,1,0.00120,12613,15.13639,83329
637,pchmykh,1,0.00120,12614,15.13759,83329
638,pdaverh,1,0.00120,12615,15.13879,83329
639,peedy2495,1,0.00120,12616,15.13999,83329
640,peterclauterbach,1,0.00120,12617,15.14119,83329
641,Peyman-Borhani,1,0.00120,12618,15.14239,83329
642,phillipstr,1,0.00120,12619,15.14359,83329
643,pkrall-swi,1,0.00120,12620,15.14479,83329
644,prafdin,1,0.00120,12621,15.14599,83329
645,priiduneemre,1,0.00120,12622,15.14719,83329
646,profetik-777,1,0.00120,12623,15.14839,83329
647,Pyroglyph,1,0.00120,12624,15.14959,83329
648,QuinnBast,1,0.00120,12625,15.15079,83329
649,raatti,1,0.00120,12626,15.15199,83329
650,RafaelLinux,1,0.00120,12627,15.15319,83329
651,rahbari,1,0.00120,12628,15.15439,83329
652,rajeshja,1,0.00120,12629,15.15559,83329
653,RandyMcMillan,1,0.00120,12630,15.15679,83329
654,raphaelquati,1,0.00120,12631,15.15799,83329
655,ratondeau,1,0.00120,12632,15.15919,83329
656,ravicious,1,0.00120,12633,15.16039,83329
657,ravinsharma7,1,0.00120,12634,15.16159,83329
658,rchristman89,1,0.00120,12635,15.16279,83329
659,rcsilva83,1,0.00120,12636,15.16399,83329
660,remunda,1,0.00120,12637,15.16519,83329
661,renner0e,1,0.00120,12638,15.16639,83329
662,response-404,1,0.00120,12639,15.16759,83329
663,RhavinX,1,0.00120,12640,15.16879,83329
664,rhwood,1,0.00120,12641,15.16999,83329
665,riccardo-forina,1,0.00120,12642,15.17119,83329
666,rnnr,1,0.00120,12643,15.17239,83329
667,robedpixel,1,0.00120,12644,15.17359,83329
668,RobVerduijn,1,0.00120,12645,15.17479,83329
669,rtritto,1,0.00120,12646,15.17599,83329
670,salaheddine-zemmouri,1,0.00120,12647,15.17719,83329
671,Salzorian,1,0.00120,12648,15.17839,83329
672,Samge0,1,0.00120,12649,15.17959,83329
673,samolesen,1,0.00120,12650,15.18079,83329
674,SamTV12345,1,0.00120,12651,15.18199,83329
675,samuk190,1,0.00120,12652,15.18319,83329
676,savagematt,1,0.00120,12653,15.18439,83329
677,savbran,1,0.00120,12654,15.18559,83329
678,sdemjanenko,1,0.00120,12655,15.18679,83329
679,sean-cmp-impact,1,0.00120,12656,15.18799,83329
680,Sebastian-Hirsch,1,0.00120,12657,15.18919,83329
681,sebastian-pf9,1,0.00120,12658,15.19039,83329
682,SemnoSao,1,0.00120,12659,15.19159,83329
683,Semo,1,0.00120,12660,15.19279,83329
684,s-en-o,1,0.00120,12661,15.19399,83329
685,serhiiKalchenko,1,0.00120,12662,15.19519,83329
686,shane99a,1,0.00120,12663,15.19639,83329
687,shemanaev,1,0.00120,12664,15.19759,83329
688,shinjiikari256,1,0.00120,12665,15.19879,83329
689,shivdhar,1,0.00120,12666,15.19999,83329
690,Shreyashwaghe,1,0.00120,12667,15.20119,83329
691,shussey,1,0.00120,12668,15.20239,83329
692,skchinna7,1,0.00120,12669,15.20359,83329
693,skyhoshi,1,0.00120,12670,15.20479,83329
694,slyfer,1,0.00120,12671,15.20599,83329
695,smfeest,1,0.00120,12672,15.20719,83329
696,Soap1196,1,0.00120,12673,15.20839,83329
697,soltanireza65,1,0.00120,12674,15.20959,83329
698,specter119,1,0.00120,12675,15.21079,83329
699,spk57,1,0.00120,12676,15.21199,83329
700,spmfox,1,0.00120,12677,15.21319,83329
701,ssnivlek,1,0.00120,12678,15.21439,83329
702,sthapa,1,0.00120,12679,15.21559,83329
703,stickster,1,0.00120,12680,15.21679,83329
704,stkr22,1,0.00120,12681,15.21799,83329
705,SubOptimal,1,0.00120,12682,15.21919,83329
706,subshade,1,0.00120,12683,15.22039,83329
707,Supermath101,1,0.00120,12684,15.22159,83329
708,sworisbreathing,1,0.00120,12685,15.22279,83329
709,szarykott,1,0.00120,12686,15.22399,83329
710,TahaAttari,1,0.00120,12687,15.22519,83329
711,tapaniantonrundgren,1,0.00120,12688,15.22639,83329
712,tcelestino,1,0.00120,12689,15.22759,83329
713,tdeverdiere,1,0.00120,12690,15.22879,83329
714,techAdamWilliams,1,0.00120,12691,15.22999,83329
715,techcomplit,1,0.00120,12692,15.23119,83329
716,TeFiLeDo,1,0.00120,12693,15.23239,83329
717,tepene,1,0.00120,12694,15.23359,83329
718,thecb4,1,0.00120,12695,15.23479,83329
719,thecooldrop,1,0.00120,12696,15.23599,83329
720,THEETB,1,0.00120,12697,15.23719,83329
721,ThePMO,1,0.00120,12698,15.23839,83329
722,TheWurst,1,0.00120,12699,15.23959,83329
723,thomasfinstad,1,0.00120,12700,15.24079,83329
724,thromera,1,0.00120,12701,15.24199,83329
725,thunderbirdtr,1,0.00120,12702,15.24319,83329
726,timReynolds,1,0.00120,12703,15.24439,83329
727,TimTaylor,1,0.00120,12704,15.24559,83329
728,TinyZzh,1,0.00120,12705,15.24679,83329
729,tjajt,1,0.00120,12706,15.24799,83329
730,tjeerdhans,1,0.00120,12707,15.24919,83329
731,tom8zds,1,0.00120,12708,15.25039,83329
732,tomaszkrzyzanowski,1,0.00120,12709,15.25159,83329
733,tomgoren,1,0.00120,12710,15.25279,83329
734,tqq1994516,1,0.00120,12711,15.25399,83329
735,TroySchmidt,1,0.00120,12712,15.25519,83329
736,ucomesdag,1,0.00120,12713,15.25639,83329
737,Unbalanced-Tree,1,0.00120,12714,15.25759,83329
738,veerpatil,1,0.00120,12715,15.25879,83329
739,VentGrey,1,0.00120,12716,15.25999,83329
740,versionbayjc,1,0.00120,12717,15.26119,83329
741,vgrme,1,0.00120,12718,15.26239,83329
742,Viltersten,1,0.00120,12719,15.26359,83329
743,Vitaly-Work,1,0.00120,12720,15.26479,83329
744,VVishwakarmaSibros,1,0.00120,12721,15.26599,83329
745,w2wewwww,1,0.00120,12722,15.26719,83329
746,wensenz,1,0.00120,12723,15.26839,83329
747,xiebaowang-boss,1,0.00120,12724,15.26959,83329
748,xvrlsc,1,0.00120,12725,15.27079,83329
749,xxTBxx,1,0.00120,12726,15.27199,83329
750,yasirmturk,1,0.00120,12727,15.27319,83329
751,yoursmanish,1,0.00120,12728,15.27439,83329
752,yunnysunny,1,0.00120,12729,15.27559,83329
753,ZaDarkSide,1,0.00120,12730,15.27679,83329
754,ZanzaZanzara,1,0.00120,12731,15.27799,83329
755,Zeratoxx,1,0.00120,12732,15.27919,83329
756,zezo2019,1,0.00120,12733,15.28039,83329
757,Zhejing-Chin,1,0.00120,12734,15.28159,83329
758,zikzakjack,1,0.00120,12735,15.28279,83329
